"cell_id"	"cell_type"
"organoid1.GCCTCTAGTCGGATCC"	"RG"
"organoid1.GAACATCGTCTGATCA"	"RG"
"organoid1.GTGTTAGGTCTGCCAG"	"Cycling"
"organoid1.TTCTCAATCGAATCCA"	"Cycling"
"organoid1.CCACTACAGGGCACTA"	"Cycling"
"organoid1.TCGCGTTCATCCGGGT"	"Cycling"
"organoid1.GTACTCCTCAACACAC"	"Cycling"
"organoid1.AAACGGGCATCAGTCA"	"RG"
"organoid1.CAGCCGATCTCTGAGA"	"Cycling"
"organoid1.CTTTGCGCAATCTACG"	"Cycling"
"organoid1.CAACCTCCAGCATACT"	"Cycling"
"organoid1.TGAGAGGGTTCCACTC"	"Cycling"
"organoid1.TTAGTTCTCAATCACG"	"Cycling"
"organoid1.CTCGGAGTCCATGAGT"	"Cycling"
"organoid1.GTCAAGTGTAAGTAGT"	"Cycling"
"organoid1.ACGATACCACGTTGGC"	"Cycling"
"organoid1.CAACCAACATTAGCCA"	"Cycling"
"organoid1.TCAACGAAGGGTTTCT"	"Cycling"
"organoid1.AGTTGGTTCAACTCTT"	"Cycling"
"organoid1.TGCTACCGTATATGGA"	"RG"
"organoid1.AGATCTGCACGGCGTT"	"RG"
"organoid1.AGGTCCGTCCCTGACT"	"Cycling"
"organoid1.GACAGAGAGACAGACC"	"RG"
"organoid1.GCCAAATCACCTCGGA"	"Cycling"
"organoid1.CATCCACGTAAGTTCC"	"Cycling"
"organoid1.TGAGAGGCATCATCCC"	"Cycling"
"organoid1.AACTCCCAGCCAGTAG"	"Cycling"
"organoid1.GCCAAATTCGAATGCT"	"RG"
"organoid1.TCTTCGGGTCCAGTTA"	"Cycling"
"organoid1.GGACAGAGTCAAAGAT"	"Cycling"
"organoid1.CAAGGCCGTACAGTTC"	"Cycling"
"organoid1.CGATTGATCTCGCATC"	"Cycling"
"organoid1.TCTGGAACAGACGCTC"	"RG"
"organoid1.TCGTAGATCCGAATGT"	"RG"
"organoid1.CAGCATAGTAGCTAAA"	"RG"
"organoid1.AAGGTTCAGTGTCCAT"	"Cycling"
"organoid1.ACGTCAAGTACTCGCG"	"Cycling"
"organoid1.GTCACAAGTGCTTCTC"	"RG"
"organoid1.GAACATCAGAACTCGG"	"RG"
"organoid1.GACTAACCAAATCCGT"	"Cycling"
"organoid1.ATTTCTGGTTACCGAT"	"Cycling"
"organoid1.ACCGTAATCACGAAGG"	"Cycling"
"organoid1.GGTATTGGTTCGGGCT"	"Cycling"
"organoid1.CAAGATCCAGCTCCGA"	"Cycling"
"organoid1.CTCGTACCATACTACG"	"Cycling"
"organoid1.AGAGCTTAGGTGATTA"	"Cycling"
"organoid1.AGAATAGCACGTGAGA"	"Cycling"
"organoid1.TGGTTCCCAGGGCATA"	"Cycling"
"organoid1.AGCGTCGCAGGTCCAC"	"Cycling"
"organoid1.ACGCCGAGTTAAGTAG"	"Cycling"
"organoid1.AGTGAGGTCTGAGTGT"	"RG"
"organoid1.ACTTACTAGGGATCTG"	"RG"
"organoid1.AGACGTTGTAGCTTGT"	"RG"
"organoid1.ACGGGTCCACCGTTGG"	"Cycling"
"organoid1.TAGTGGTCACGGTAAG"	"RG"
"organoid1.TCATTACCATGCAACT"	"Cycling"
"organoid1.GGACAGATCACCGGGT"	"Cycling"
"organoid1.CCAATCCAGAATTGTG"	"Cycling"
"organoid1.CTCATTACACAGATTC"	"Cycling"
"organoid1.GACACGCCAGGCTCAC"	"Cycling"
"organoid1.CTCAGAAGTTATTCTC"	"Cycling"
"organoid1.CTGCGGAAGATGGCGT"	"Cycling"
"organoid1.CATGACAAGAATAGGG"	"Cycling"
"organoid1.TGGCCAGAGAAACCGC"	"Cycling"
"organoid1.GGAGCAAGTCAGAGGT"	"Cycling"
"organoid1.AGGTCATCACAGCCCA"	"Cycling"
"organoid1.AGATCTGAGGCATGGT"	"Cycling"
"organoid1.ACATACGAGAGTCTGG"	"Cycling"
"organoid1.GAAGCAGGTATATGGA"	"Cycling"
"organoid1.CCCTCCTTCTGGTATG"	"Cycling"
"organoid1.TGTCCCACACAAGACG"	"Cycling"
"organoid1.GATCTAGCAAACGTGG"	"Cycling"
"organoid1.TCATTACGTTATCCGA"	"Cycling"
"organoid1.CGCCAAGTCCTGTACC"	"RG"
"organoid1.CAACCTCCACTACAGT"	"RG"
"organoid1.CCTAAAGGTCCTGCTT"	"RG"
"organoid1.CGAATGTGTTACGTCA"	"Cycling"
"organoid1.TATCAGGGTTGTGGCC"	"Cycling"
"organoid1.CGGACGTTCGAACTGT"	"Cycling"
"organoid1.GACCAATCACGGCTAC"	"Cycling"
"organoid1.AAAGCAAAGGTGGGTT"	"Cycling"
"organoid1.GCAAACTTCCTAGAAC"	"Cycling"
"organoid1.CACTCCAGTCAAGCGA"	"Cycling"
"organoid1.GAATGAAGTCCATGAT"	"Cycling"
"organoid1.TATCTCAGTTGGTGGA"	"RG"
"organoid1.ACCAGTACACCAGGCT"	"RG"
"organoid1.ACATCAGAGCCACGTC"	"Cycling"
"organoid1.GATTCAGCACCAGGCT"	"Cycling"
"organoid1.GCAAACTCAATGAATG"	"RG"
"organoid1.TTGTAGGTCGAATGCT"	"RG"
"organoid1.GGGCACTTCAGAGCTT"	"Cycling"
"organoid1.AACCATGTCTTACCTA"	"RG"
"organoid1.GCTTCCATCGCATGGC"	"Cycling"
"organoid1.CGCTATCGTTCCACGG"	"Cycling"
"organoid1.GGATGTTTCCACGCAG"	"Cycling"
"organoid1.GACCAATCACTTAAGC"	"Cycling"
"organoid1.CTGGTCTCAATCACAC"	"RG"
"organoid1.CGATGTAAGTGTGAAT"	"Cycling"
"organoid1.GCATGATCAGACAAAT"	"Cycling"
"organoid1.CGCTTCAAGAGTAATC"	"Cycling"
"organoid1.GAATAAGGTTACGTCA"	"Cycling"
"organoid1.ATCTGCCTCAACACGT"	"Cycling"
"organoid1.GATGCTAAGTGTTTGC"	"Cycling"
"organoid1.CTGATCCGTCAACTGT"	"Cycling"
"organoid1.ATCTACTAGTGTTAGA"	"RG"
"organoid1.GTTCATTGTGCAGACA"	"Cycling"
"organoid1.CTCGTACCAATGAAAC"	"RG"
"organoid1.CCTTCCCAGATGAGAG"	"Cycling"
"organoid1.CCTATTAGTACATGTC"	"Cycling"
"organoid1.TGACGGCGTCATATGC"	"Cycling"
"organoid1.TGCACCTAGTTGAGAT"	"Cycling"
"organoid1.TCGCGAGCAGACACTT"	"Cycling"
"organoid1.ACGAGCCCATCGGAAG"	"Cycling"
"organoid1.GACTGCGCAGGGTACA"	"Cycling"
"organoid1.TATGCCCTCTGATTCT"	"Cycling"
"organoid1.TCAGGATCAATTCCTT"	"RG"
"organoid1.TGTCCCAAGTTACGGG"	"Cycling"
"organoid1.CACAGGCTCAGCATGT"	"Cycling"
"organoid1.AGTCTTTGTTATGCGT"	"RG"
"organoid1.CAAGTTGAGTTTAGGA"	"Cycling"
"organoid1.TGAAAGACATAGACTC"	"RG"
"organoid1.CATCAGAAGGCAAAGA"	"RG"
"organoid1.CATGGCGAGGCGACAT"	"RG"
"organoid1.AACTTTCAGTCTCCTC"	"Cycling"
"organoid1.GCATGTAAGCTACCGC"	"RG"
"organoid1.TTGCCGTTCCCAAGTA"	"Cycling"
"organoid1.GGAGCAAGTCGATTGT"	"Cycling"
"organoid1.GTCGGGTCATAGGATA"	"Cycling"
"organoid1.CAACCAAGTGATGATA"	"Cycling"
"organoid1.CACATAGGTTAAAGTG"	"RG"
"organoid1.GCAGTTATCAGGTTCA"	"Cycling"
"organoid1.AAAGTAGAGTCACGCC"	"Cycling"
"organoid1.TCACGAATCTGTTTGT"	"Cycling"
"organoid1.GCCTCTACATCGTCGG"	"Cycling"
"organoid1.GGAGCAAGTCTAGTGT"	"RG"
"organoid1.GACTAACCAAGTACCT"	"Cycling"
"organoid1.GTAACTGAGGACAGAA"	"RG"
"organoid1.TTCGAAGTCGCCTGAG"	"Cycling"
"organoid1.GGACAGACACTGAAGG"	"Cycling"
"organoid1.CAGCTAAGTCGCTTTC"	"Cycling"
"organoid1.CTTACCGTCATGCAAC"	"Cycling"
"organoid1.AGACGTTCAACCGCCA"	"Cycling"
"organoid1.CCCAATCGTGGTACAG"	"Cycling"
"organoid1.TCATTTGAGAAACGCC"	"RG"
"organoid1.AGCGTATAGTAGATGT"	"Cycling"
"organoid1.CACATTTAGAGCTGGT"	"Cycling"
"organoid1.GTGCTTCAGTAGGTGC"	"Cycling"
"organoid1.ATCGAGTCATGAGCGA"	"Cycling"
"organoid1.CCTAGCTTCCCTTGTG"	"RG"
"organoid1.TACTTACCAGTCAGCC"	"RG"
"organoid1.CATATTCTCCTGCCAT"	"Cycling"
"organoid1.CACAGTAGTTGGACCC"	"Cycling"
"organoid1.CCGTTCATCCCAACGG"	"Cycling"
"organoid1.ACGAGCCCACATGACT"	"Cycling"
"organoid1.CATATGGGTTCCACTC"	"Cycling"
"organoid1.TCAACGAAGTTGTAGA"	"RG"
"organoid1.GGAAAGCCAGCCTATA"	"RG"
"organoid1.GGACAAGGTGTGACGA"	"Cycling"
"organoid1.AGCGTATAGTCTCGGC"	"RG"
"organoid1.CCTTTCTTCTTCAACT"	"Cycling"
"organoid1.CATGGCGCAGCCAGAA"	"Cycling"
"organoid1.CAGCTGGCAAGGTTTC"	"Cycling"
"organoid1.CCGTACTAGACTACAA"	"Cycling"
"organoid1.TTGACTTGTTTGACTG"	"Cycling"
"organoid1.TACCTATCAGCTTCGG"	"RG"
"organoid1.CAGCGACGTCATGCAT"	"Cycling"
"organoid1.AGAGCGAAGATCTGAA"	"Cycling"
"organoid1.ACGGGCTAGTAGCCGA"	"RG"
"organoid1.TGAGGGAGTGCAGTAG"	"Cycling"
"organoid1.GTCGTAAAGTTAGCGG"	"RG"
"organoid1.CGGGTCAGTCCCTACT"	"RG"
"organoid1.AACTCAGCACAACTGT"	"Cycling"
"organoid1.AGGGTGACAAGTTAAG"	"Cycling"
"organoid1.TTAGGACAGCCTCGTG"	"Cycling"
"organoid1.CAGCGACGTATAGGTA"	"RG"
"organoid1.CAAGGCCGTCGCATAT"	"RG"
"organoid1.GCGCGATAGAGGTAGA"	"RG"
"organoid1.CGGAGTCCACCTTGTC"	"Cycling"
"organoid1.GACGCGTAGCTAACTC"	"Cycling"
"organoid1.ACTATCTAGAGTAAGG"	"Cycling"
"organoid1.CGATTGACAAGAAGAG"	"Cycling"
"organoid1.CGTTCTGGTGCTTCTC"	"Cycling"
"organoid1.TCCCGATCAGTAGAGC"	"Cycling"
"organoid1.TGCCCATTCTGCTGCT"	"Cycling"
"organoid1.CTCTAATAGATAGGAG"	"Cycling"
"organoid1.CTGAAACCAGTAGAGC"	"Cycling"
"organoid1.GGCGTGTCACGGTTTA"	"Cycling"
"organoid1.ACTGATGCAAGGACTG"	"Cycling"
"organoid1.TTGGAACTCCAAGTAC"	"RG"
"organoid1.TCAACGAGTCCAGTTA"	"Cycling"
"organoid1.GCGCAACGTAAGTGGC"	"RG"
"organoid1.GGGACCTAGGGAAACA"	"Cycling"
"organoid1.CCATGTCCAGACGCTC"	"Cycling"
"organoid1.CGTCCATCATGGTCTA"	"Cycling"
"organoid1.CTCGAAAAGAGTAAGG"	"Cycling"
"organoid1.GACGTGCCATTCGACA"	"Cycling"
"organoid1.GCGACCAGTTGCGCAC"	"Cycling"
"organoid1.CAGATCACATTGTGCA"	"Cycling"
"organoid1.CAGCATAAGCACCGTC"	"RG"
"organoid1.TCAGATGGTATAGTAG"	"RG"
"organoid1.GTGCATATCTTGTCAT"	"RG"
"organoid1.GTCACGGGTCCGAAGA"	"Cycling"
"organoid1.GCGAGAAGTCACTTCC"	"RG"
"organoid1.TCAGGATGTCACTGGC"	"RG"
"organoid1.AAAGCAAAGTCAAGCG"	"Cycling"
"organoid1.TGAGAGGAGAGCAATT"	"RG"
"organoid1.GTCTTCGCAATCGGTT"	"Cycling"
"organoid1.TGAGCCGTCGGCGGTT"	"Cycling"
"organoid1.GTTAAGCAGAGTCTGG"	"Cycling"
"organoid1.GACCAATTCCGCATAA"	"Cycling"
"organoid1.TGACTAGAGGTGCAAC"	"Cycling"
"organoid1.TCGCGTTAGTAACCCT"	"Cycling"
"organoid1.ACTGAGTTCTTCTGGC"	"Cycling"
"organoid1.CATCAAGCAGCCTATA"	"Cycling"
"organoid1.GTCACGGCACATTCGA"	"RG"
"organoid1.GTAACTGAGATCCTGT"	"Cycling"
"organoid1.ACTTGTTAGTTGTCGT"	"Cycling"
"organoid1.GGTGTTACACCACCAG"	"Cycling"
"organoid1.ACAGCTAAGCTATGCT"	"RG"
"organoid1.GTGTTAGCAACTGCGC"	"Cycling"
"organoid1.CCTACACGTTTGCATG"	"Cycling"
"organoid1.CACATTTCACGTAAGG"	"Cycling"
"organoid1.TGAGCATGTGAGGGAG"	"Cycling"
"organoid1.GTATCTTGTAAGGGCT"	"RG"
"organoid1.GGGACCTCACTGCCAG"	"Cycling"
"organoid1.GATCTAGTCAGTTAGC"	"RG"
"organoid1.CAAGGCCTCTGTCAAG"	"Cycling"
"organoid1.GCTGCTTGTCTTGATG"	"Cycling"
"organoid1.CGCTATCCATCGGTTA"	"Cycling"
"organoid1.ATCTGCCAGCTCCCAG"	"Cycling"
"organoid1.TCTCTAACAGCTTCGG"	"RG"
"organoid1.TGGACGCGTAGCACGA"	"Cycling"
"organoid1.CGGTTAAGTTTAGCTG"	"RG"
"organoid1.ACACCAAGTTCGGGCT"	"Cycling"
"organoid1.ACACTGATCCACTCCA"	"Cycling"
"organoid1.ACGGCCAGTTGCGTTA"	"Cycling"
"organoid1.CAGCTAAAGGGATGGG"	"Cycling"
"organoid1.GCTCTGTCACTCAGGC"	"RG"
"organoid1.GTCGGGTGTACTCAAC"	"Cycling"
"organoid1.AGCTCCTCACCAGGTC"	"RG"
"organoid1.ACGGCCAGTTCCTCCA"	"Cycling"
"organoid1.GGAATAAAGAGTTGGC"	"RG"
"organoid1.CCTAGCTGTACCTACA"	"RG"
"organoid1.TTGCCGTCACGGACAA"	"Cycling"
"organoid1.GACTGCGCACCACCAG"	"Cycling"
"organoid1.GGGTTGCGTCGACTGC"	"Cycling"
"organoid1.GTAACTGCACGAGGTA"	"Cycling"
"organoid1.TCAATCTCACGGTGTC"	"RG"
"organoid1.TCAGGTAGTTGACGTT"	"Cycling"
"organoid1.CGTCAGGGTTTAGCTG"	"RG"
"organoid1.ACGAGCCCATCGACGC"	"Cycling"
"organoid1.CATGCCTGTAGAGTGC"	"RG"
"organoid1.CATATTCCATCTCGCT"	"Cycling"
"organoid1.GACGTGCGTGGTACAG"	"Cycling"
"organoid1.TGAGCATTCACGCGGT"	"RG"
"organoid1.AACACGTTCTAGAGTC"	"RG"
"organoid1.CAGCTGGAGCAGCCTC"	"RG"
"organoid1.AGTGGGAAGTTTCCTT"	"RG"
"organoid1.TCAGCTCTCTACTATC"	"RG"
"organoid1.GTACTCCAGCCCTAAT"	"RG"
"organoid1.CCTAAAGAGCTGTTCA"	"Cycling"
"organoid1.ACGCCAGGTCTCCATC"	"RG"
"organoid1.ACTATCTGTTGTGGAG"	"RG"
"organoid1.GTCACAATCTATCCCG"	"Cycling"
"organoid1.AAGGAGCGTGTGACCC"	"RG"
"organoid1.CACAGGCCAGGTCTCG"	"Cycling"
"organoid1.CGTCAGGCACAGGAGT"	"Cycling"
"organoid1.TGGCTGGGTCAGCTAT"	"RG"
"organoid1.ATCATGGAGCCTTGAT"	"RG"
"organoid1.CGAGAAGGTTGAGGTG"	"RG"
"organoid1.GACCTGGCATGGTCTA"	"Cycling"
"organoid1.ACACCCTCATCTCGCT"	"RG"
"organoid1.AAGTCTGTCAGTTCGA"	"Cycling"
"organoid1.CTACGTCAGACTAGGC"	"Cycling"
"organoid1.TGACAACGTGCTTCTC"	"RG"
"organoid1.TCCCGATAGATGGCGT"	"Cycling"
"organoid1.CGACTTCCATCGTCGG"	"RG"
"organoid1.CAAGGCCCACATAACC"	"RG"
"organoid1.AAACCTGCACGAGGTA"	"Cycling"
"organoid1.CGTAGGCGTTGCCTCT"	"Cycling"
"organoid1.GCTGCGATCATAGCAC"	"Cycling"
"organoid1.CATGGCGGTCCGAATT"	"RG"
"organoid1.TACCTTACATCGATGT"	"RG"
"organoid1.GATCGCGAGTGTACTC"	"RG"
"organoid1.ACTGAACAGACAGACC"	"Cycling"
"organoid1.TTCTCAATCTCTAAGG"	"Cycling"
"organoid1.GAAACTCAGCGTCTAT"	"Cycling"
"organoid1.CACACCTGTTCCCGAG"	"RG"
"organoid1.TACTTGTCATCAGTAC"	"RG"
"organoid1.GTGTTAGAGAGTCGGT"	"Cycling"
"organoid1.GTACTTTTCGGCTTGG"	"RG"
"organoid1.CGGACACCACATCCAA"	"RG"
"organoid1.GGAACTTAGAGCAATT"	"Cycling"
"organoid1.AAGGAGCCACAAGCCC"	"RG"
"organoid1.GACACGCCACAGATTC"	"RG"
"organoid1.CGAGAAGTCTTCCTTC"	"Cycling"
"organoid1.TCAATCTGTGTGCGTC"	"RG"
"organoid1.AGGCCGTCAGTATCTG"	"RG"
"organoid1.GGTATTGCAGCCAGAA"	"RG"
"organoid1.TTCTCAAGTGCTGTAT"	"RG"
"organoid1.TTTGTCAAGTGAAGTT"	"Cycling"
"organoid1.CAGTCCTCAGCAGTTT"	"RG"
"organoid1.GATCTAGTCCTTGACC"	"RG"
"organoid1.AGAGCGACAAGGTTTC"	"RG"
"organoid1.GGATGTTGTACAGTGG"	"RG"
"organoid1.GTGCGGTCATGGTCAT"	"RG"
"organoid1.GCTTCCAAGACTAGAT"	"Cycling"
"organoid1.TCTGGAAAGCTAGTGG"	"RG"
"organoid1.CGTGTAAAGAGGGCTT"	"RG"
"organoid1.CAAGGCCTCGCCTGTT"	"RG"
"organoid1.CGCGGTACAGGTCTCG"	"Cycling"
"organoid1.TTGCGTCAGTCAAGGC"	"RG"
"organoid1.AAGCCGCGTCCCTACT"	"RG"
"organoid1.GATTCAGGTCTCTCTG"	"RG"
"organoid1.TGTGTTTGTTCCGGCA"	"Cycling"
"organoid1.TGGCCAGAGTCGTTTG"	"RG"
"organoid1.AGTGTCACACGTCAGC"	"RG"
"organoid1.TCGAGGCCAGTGAGTG"	"RG"
"organoid1.TGACTTTAGGTAAACT"	"RG"
"organoid1.AGGCCACAGTCCTCCT"	"RG"
"organoid1.TAAGTGCAGCTTTGGT"	"RG"
"organoid1.GTCCTCATCGGCCGAT"	"RG"
"organoid1.GTCGTAATCTAGAGTC"	"RG"
"organoid1.TGAGAGGCATGTCCTC"	"RG"
"organoid1.ACTGAGTCAAACGCGA"	"RG"
"organoid1.CATCGGGGTCGACTGC"	"RG"
"organoid1.TCTGGAAGTAGGAGTC"	"Cycling"
"organoid1.ATCTACTCACATCCGG"	"RG"
"organoid1.ATTACTCTCCATGAAC"	"RG"
"organoid1.GTTAAGCGTACTCTCC"	"Cycling"
"organoid1.AGAATAGAGAACAATC"	"RG"
"organoid1.ACGCCGAGTACCGGCT"	"Cycling"
"organoid1.AGCCTAAGTCGGATCC"	"RG"
"organoid1.GTCACAACACGGTAGA"	"RG"
"organoid1.TTATGCTAGGCAATTA"	"RG"
"organoid1.CGGGTCACAATGGAAT"	"RG"
"organoid1.AACACGTGTATCACCA"	"RG"
"organoid1.AGGGTGAGTTGGTAAA"	"Cycling"
"organoid1.GCAGTTAAGTAGATGT"	"RG"
"organoid1.CGAACATGTCGCTTCT"	"RG"
"organoid1.CTCATTAGTCATGCAT"	"Cycling"
"organoid1.AGGCCACAGGCCCTTG"	"RG"
"organoid1.TACCTTATCTGAAAGA"	"RG"
"organoid1.GAGGTGACACTGTGTA"	"Cycling"
"organoid1.CATCAAGCAAGTCATC"	"Cycling"
"organoid1.CGAATGTTCGTCTGAA"	"Cycling"
"organoid1.CTAACTTGTTCCACAA"	"RG"
"organoid1.CTACGTCGTCGGCATC"	"RG"
"organoid1.AGCTCTCCACAGACTT"	"RG"
"organoid1.GCGCGATAGTTCCACA"	"RG"
"organoid1.ATCTGCCTCGTGACAT"	"Cycling"
"organoid1.TGAAAGAAGCAACGGT"	"Cycling"
"organoid1.GTGAAGGGTATAAACG"	"Cycling"
"organoid1.GGCGTGTTCACGATGT"	"RG"
"organoid1.TGAGCATCAGTTTACG"	"Cycling"
"organoid1.CAGCGACGTCCGAACC"	"RG"
"organoid1.GGCGACTGTTATCGGT"	"Cycling"
"organoid1.CGAGAAGCAAGTCATC"	"Cycling"
"organoid1.GCTCTGTCAAAGGAAG"	"RG"
"organoid1.TTGTAGGTCCTTTCGG"	"RG"
"organoid1.CATCCACTCGCTAGCG"	"Cycling"
"organoid1.TTTGGTTGTCACACGC"	"Cycling"
"organoid1.TTTGTCAGTGCAACTT"	"RG"
"organoid1.ACCTTTATCGCCTGTT"	"RG"
"organoid1.CGTTAGACATAAAGGT"	"RG"
"organoid1.CACATTTGTGCTTCTC"	"RG"
"organoid1.GTAACTGAGTATGACA"	"RG"
"organoid1.ATTACTCTCGAGGTAG"	"RG"
"organoid1.TTGCCGTAGTGAATTG"	"RG"
"organoid1.GACAGAGGTGCACGAA"	"RG"
"organoid1.GATCGCGTCGGTCTAA"	"RG"
"organoid1.TGGCGCACATGGTTGT"	"RG"
"organoid1.TCAGGTATCGCGATCG"	"RG"
"organoid1.GCTTCCACAGTCAGAG"	"RG"
"organoid1.ACTTTCAGTGTCTGAT"	"RG"
"organoid1.GGATGTTTCACGATGT"	"RG"
"organoid1.GCATGATGTCGGCACT"	"RG"
"organoid1.TTCTACAGTGTCCTCT"	"Cycling"
"organoid2.GAACCTAAGGGTATCG"	"Cycling"
"organoid2.CATGGCGAGTGTTAGA"	"RG"
"organoid2.TTAACTCAGGCCCGTT"	"Cycling"
"organoid2.CTACATTCACTGTGTA"	"RG"
"organoid2.GGAATAAGTGCGATAG"	"RG"
"organoid2.TGACGGCCACAGCCCA"	"RG"
"organoid2.CGAACATGTCTGATTG"	"RG"
"organoid2.TAGACCATCTCAAACG"	"Cycling"
"organoid2.TGAGCCGCATGGTCTA"	"RG"
"organoid2.CATATGGCAATCACAC"	"RG"
"organoid2.GTGCATATCATCTGTT"	"Cycling"
"organoid2.TGAGAGGAGCTAGTTC"	"Cycling"
"organoid2.CGGACTGCACGAAGCA"	"RG"
"organoid2.TGACAACCATCCAACA"	"Cycling"
"organoid2.GTATTCTCAAAGTGCG"	"Cycling"
"organoid2.GCTTGAATCGTTACAG"	"Cycling"
"organoid2.TCTATTGCACGAAATA"	"RG"
"organoid2.TCAGGATCAAACCTAC"	"Cycling"
"organoid2.TGGGAAGCAAACTGTC"	"RG"
"organoid2.GTTCATTTCTCGCATC"	"RG"
"organoid2.ACCGTAAAGAACTGTA"	"Cycling"
"organoid2.GTAGTCACACTGAAGG"	"Cycling"
"organoid2.GCATACATCCTCCTAG"	"RG"
"organoid2.CAGCAGCTCGGAATCT"	"RG"
"organoid2.AAATGCCGTCTCCACT"	"RG"
"organoid2.CCTTCGACACCTATCC"	"Cycling"
"organoid2.GACTAACGTGCCTGGT"	"Cycling"
"organoid2.CGCGTTTAGCAATCTC"	"Cycling"
"organoid2.GTAACGTTCCACGTGG"	"RG"
"organoid2.TACTCGCTCCTGCAGG"	"Cycling"
"organoid2.TTCTCAACATTACCTT"	"Cycling"
"organoid2.TGCTACCCATACAGCT"	"RG"
"organoid2.CTAGTGACACCGGAAA"	"Cycling"
"organoid2.TTGTAGGTCTATCCTA"	"RG"
"organoid2.TGAGGGATCGTTACGA"	"RG"
"organoid2.GACTACACACAGAGGT"	"RG"
"organoid2.GACACGCCAAGCGTAG"	"Cycling"
"organoid2.GCCAAATGTTTGTTTC"	"Cycling"
"organoid2.TGTTCCGCACGACTCG"	"RG"
"organoid2.ATTCTACCATCTCGCT"	"RG"
"organoid2.CTCTACGAGACAATAC"	"RG"
"organoid2.GAACCTACAACTTGAC"	"Cycling"
"organoid2.GCTCTGTAGGTAGCCA"	"Cycling"
"organoid2.AGGCCACCAGTTCCCT"	"RG"
"organoid2.GTCATTTTCCGTTGCT"	"Cycling"
"organoid2.TCAGGATGTAGCCTAT"	"Cycling"
"organoid2.CGACTTCGTCCAGTGC"	"RG"
"organoid2.ACTGATGTCCTTTCGG"	"Cycling"
"organoid2.TGACAACCATAAGACA"	"Cycling"
"organoid2.GGCTCGAGTACATCCA"	"RG"
"organoid2.GATGAAACAGTGACAG"	"Cycling"
"organoid2.TCTCTAAGTCTTCAAG"	"RG"
"organoid2.GTCGTAACAATACGCT"	"RG"
"organoid2.CCTAAAGCACGAAAGC"	"Cycling"
"organoid2.CTCGAAATCTTCTGGC"	"Cycling"
"organoid2.ACATCAGTCATTGCCC"	"Cycling"
"organoid2.CTGGTCTTCCTAGAAC"	"RG"
"organoid2.ACGATACAGGACAGCT"	"Cycling"
"organoid2.ACCAGTAAGAGCTGCA"	"Cycling"
"organoid2.GACGTGCTCCTTGGTC"	"Cycling"
"organoid2.CTCGAGGTCTCGATGA"	"Cycling"
"organoid2.CCAATCCTCATGCTCC"	"Cycling"
"organoid2.TTAGTTCGTCGAATCT"	"Cycling"
"organoid2.CTCTACGGTCTTGTCC"	"Cycling"
"organoid2.ATCGAGTAGGCCCTTG"	"RG"
"organoid2.CAAGGCCAGGCTATCT"	"Cycling"
"organoid2.GACTAACTCGAATGGG"	"RG"
"organoid2.GCTGCAGTCCACTGGG"	"RG"
"organoid2.CTCTGGTCACATCTTT"	"Cycling"
"organoid2.CGTCTACCATGCATGT"	"Cycling"
"organoid2.CCTTACGCATGGAATA"	"Cycling"
"organoid2.GAGGTGATCTCAAACG"	"Cycling"
"organoid2.CGCGGTAAGCCGATTT"	"Cycling"
"organoid2.TAAACCGTCTTGAGGT"	"RG"
"organoid2.AGTGGGAGTGAGGGTT"	"RG"
"organoid2.GGCGTGTGTCTGCGGT"	"RG"
"organoid2.CTAAGACGTGAGTGAC"	"Cycling"
"organoid2.CGGACTGTCAACGCTA"	"Cycling"
"organoid2.TCTATTGGTGGCCCTA"	"Cycling"
"organoid2.CCACTACAGAATTCCC"	"RG"
"organoid2.GCGCAGTAGGAATTAC"	"RG"
"organoid2.TCGGTAACATCATCCC"	"Cycling"
"organoid2.AGTGTCAGTAGCTCCG"	"Cycling"
"organoid2.GGACAAGTCACTTACT"	"Cycling"
"organoid2.AACTGGTAGACATAAC"	"RG"
"organoid2.TGACTTTTCTCTGCTG"	"RG"
"organoid2.CCACCTAGTCCATCCT"	"Cycling"
"organoid2.GTCTCGTGTTCTGAAC"	"RG"
"organoid2.GATGAGGGTCGAGTTT"	"Cycling"
"organoid2.GGGCATCAGAAACCGC"	"Cycling"
"organoid2.GTTCATTAGCCCAATT"	"Cycling"
"organoid2.CCTATTAGTTCATGGT"	"RG"
"organoid2.TGGGAAGCAGCTGCTG"	"Cycling"
"organoid2.CGAGAAGCATCACCCT"	"Cycling"
"organoid2.CGATTGAAGACTCGGA"	"RG"
"organoid2.CAAGAAAGTGATAAAC"	"RG"
"organoid2.TAGCCGGCAGACAAAT"	"Cycling"
"organoid2.CGATGGCAGAGACTAT"	"RG"
"organoid2.CTCATTAAGTACACCT"	"Cycling"
"organoid2.ACGTCAAAGTGGAGAA"	"Cycling"
"organoid2.TGTCCCAGTGTTAAGA"	"Cycling"
"organoid2.TAAGTGCCATACGCCG"	"Cycling"
"organoid2.GACTACAGTGCCTTGG"	"Cycling"
"organoid2.CGAATGTCACATTTCT"	"RG"
"organoid2.GCTTGAAGTACCGTAT"	"RG"
"organoid2.ATCTACTAGGGCTTGA"	"RG"
"organoid2.TCAGCAAAGAGTAATC"	"RG"
"organoid2.TGCTGCTGTGATAAGT"	"Cycling"
"organoid2.GCTCTGTAGAAGCCCA"	"Cycling"
"organoid2.CATATTCGTTAGATGA"	"Cycling"
"organoid2.AGAGTGGGTGTGCCTG"	"Cycling"
"organoid2.GCGCAACAGCGTTTAC"	"Cycling"
"organoid2.CGAGCACTCCCTAATT"	"RG"
"organoid2.CAGATCATCTCGTATT"	"Cycling"
"organoid2.CCACGGATCTGATTCT"	"Cycling"
"organoid2.AACTGGTCACAGTCGC"	"RG"
"organoid2.TTAACTCAGTTAGCGG"	"Cycling"
"organoid2.AGGGATGAGTTAAGTG"	"RG"
"organoid2.ACCCACTTCACGAAGG"	"Cycling"
"organoid2.CTTAGGATCGGAATCT"	"Cycling"
"organoid2.TCAATCTTCTTGTCAT"	"Cycling"
"organoid2.TAGTGGTCAGGAACGT"	"Cycling"
"organoid2.CACTCCACATGGGACA"	"Cycling"
"organoid2.TTGACTTGTAATCGTC"	"Cycling"
"organoid2.GCTGCGAGTGTTGGGA"	"Cycling"
"organoid2.CGGTTAAAGCCGATTT"	"Cycling"
"organoid2.TGCGCAGGTAGCGTAG"	"Cycling"
"organoid2.CAGCGACAGGGATCTG"	"RG"
"organoid2.GGACAAGAGCTAACTC"	"Cycling"
"organoid2.ATCATGGCAATCTGCA"	"RG"
"organoid2.CTCGGAGGTAGTGAAT"	"Cycling"
"organoid2.TTGCCGTTCATGGTCA"	"RG"
"organoid2.ACTGAGTCACCCATGG"	"Cycling"
"organoid2.TCGCGTTTCCGCGCAA"	"RG"
"organoid2.GCGAGAAGTTGGAGGT"	"Cycling"
"organoid2.GCGCGATCAAGGACTG"	"Cycling"
"organoid2.TGAGAGGGTGTGCCTG"	"Cycling"
"organoid2.GCGACCACACTTAAGC"	"Cycling"
"organoid2.GTAACGTTCAAAGTAG"	"Cycling"
"organoid2.TAAGAGACACATCCAA"	"Cycling"
"organoid2.TTTGCGCCACGTAAGG"	"Cycling"
"organoid2.GTGCATACAAGGACTG"	"Cycling"
"organoid2.GGACATTAGAATTCCC"	"Cycling"
"organoid2.AAAGTAGAGATCTGCT"	"RG"
"organoid2.TGAAAGAGTCGTTGTA"	"Cycling"
"organoid2.TGACAACGTCCAAGTT"	"Cycling"
"organoid2.GTTCATTAGGGCTCTC"	"Cycling"
"organoid2.ATGAGGGCATAGACTC"	"Cycling"
"organoid2.AGCGTCGCATCTATGG"	"RG"
"organoid2.CGTTAGACATTGAGCT"	"RG"
"organoid2.CTAGTGAAGAAGGGTA"	"Cycling"
"organoid2.GGATTACGTATTACCG"	"Cycling"
"organoid2.GACCAATTCAACGCTA"	"Cycling"
"organoid2.CAACCAACATTTCAGG"	"Cycling"
"organoid2.AAACGGGCATGACGGA"	"Cycling"
"organoid2.GGGCATCAGGGTTCCC"	"RG"
"organoid2.AACTTTCGTGTAATGA"	"Cycling"
"organoid2.CCGGGATAGCTGTTCA"	"RG"
"organoid2.GACCTGGCATCGATTG"	"RG"
"organoid2.TCCCGATAGTGACATA"	"RG"
"organoid2.CATATGGTCTTCGAGA"	"RG"
"organoid2.GTAACGTCAAGTAATG"	"Cycling"
"organoid2.TACGGGCTCGGGAGTA"	"RG"
"organoid2.CACACCTTCAGGTAAA"	"RG"
"organoid2.CCCTCCTGTGTCAATC"	"Cycling"
"organoid2.GCACATAGTCCCTTGT"	"Cycling"
"organoid2.CGAACATCATGGATGG"	"RG"
"organoid2.GCACATATCGGACAAG"	"RG"
"organoid2.GTGCAGCGTTTAAGCC"	"Cycling"
"organoid2.ATCACGACAAGTAATG"	"RG"
"organoid2.CTCATTATCTTTACAC"	"Cycling"
"organoid2.CGTTGGGGTAGAGGAA"	"Cycling"
"organoid2.GGAATAAGTTACTGAC"	"RG"
"organoid2.GTCTCGTCAATTGCTG"	"Cycling"
"organoid2.TCGTAGATCTACCAGA"	"Cycling"
"organoid2.CCTACCAGTGCTGTAT"	"Cycling"
"organoid2.AAAGCAAGTTCCCTTG"	"Cycling"
"organoid2.TTAGGCAAGAACTGTA"	"Cycling"
"organoid2.TCCCGATGTCGGCTCA"	"RG"
"organoid2.AGGCCGTCACACCGAC"	"RG"
"organoid2.TCGTACCAGGCCGAAT"	"RG"
"organoid2.CTAGCCTAGATGGCGT"	"RG"
"organoid2.ATTGGTGTCTGCTGCT"	"RG"
"organoid2.CCTCAGTCAATAGCGG"	"Cycling"
"organoid2.CAGCCGATCAGGCCCA"	"Cycling"
"organoid2.CTCGTCACACGGCCAT"	"RG"
"organoid2.TGAGCCGAGGGATGGG"	"Cycling"
"organoid2.ATTGGTGCAGACACTT"	"Cycling"
"organoid2.ATTGGACCAAACGTGG"	"Cycling"
"organoid2.GTAACTGTCACAGGCC"	"Cycling"
"organoid2.AGGGATGTCTGCCCTA"	"Cycling"
"organoid2.AGATCTGAGAAGGTTT"	"Cycling"
"organoid2.CAGCCGAGTCTAGTGT"	"Cycling"
"organoid2.TACCTTATCTTACCGC"	"Cycling"
"organoid2.GTTCTCGGTATCACCA"	"RG"
"organoid2.GAACCTACATTAGCCA"	"RG"
"organoid2.TTGACTTCATGGAATA"	"Cycling"
"organoid2.ATCTACTAGGACAGCT"	"RG"
"organoid2.ACGAGCCTCTTTAGGG"	"Cycling"
"organoid2.CATGCCTGTCAGAGGT"	"Cycling"
"organoid2.CTCTGGTTCATAACCG"	"RG"
"organoid2.ATTTCTGCAGCGATCC"	"Cycling"
"organoid2.CGCTGGACATATGGTC"	"Cycling"
"organoid2.GTGGGTCAGGTGACCA"	"RG"
"organoid2.GACGTTAAGCCTCGTG"	"RG"
"organoid2.GCTTCCAGTACTCGCG"	"RG"
"organoid2.TGGACGCCATCGATTG"	"Cycling"
"organoid2.CGGTTAAAGTACGTTC"	"Cycling"
"organoid2.CTTACCGGTACTTCTT"	"RG"
"organoid2.GCGGGTTAGTCTCAAC"	"RG"
"organoid2.ATCTGCCAGCCTTGAT"	"Cycling"
"organoid2.GACCTGGTCCTAGAAC"	"Cycling"
"organoid2.CTGGTCTCAGGACGTA"	"Cycling"
"organoid2.GATCGATCAATGGACG"	"Cycling"
"organoid2.TCATTTGAGCCCAATT"	"Cycling"
"organoid2.GTACTTTCAAGCCATT"	"Cycling"
"organoid2.CCTACCACAGAGCCAA"	"Cycling"
"organoid2.ACACCAAGTACTTAGC"	"RG"
"organoid2.TCGAGGCTCCAGAGGA"	"RG"
"organoid2.GGACGTCTCATACGGT"	"Cycling"
"organoid2.TTCGGTCTCTGCGACG"	"Cycling"
"organoid2.CATTATCGTTGAACTC"	"Cycling"
"organoid2.GTTCATTGTGAGTATA"	"RG"
"organoid2.AGTGAGGGTCCGTCAG"	"RG"
"organoid2.TGAGCATGTGTCGCTG"	"Cycling"
"organoid2.GGTATTGGTAGCGTAG"	"Cycling"
"organoid2.CCGGGATCAAGCTGAG"	"Cycling"
"organoid2.TGACAACGTCTAGCCG"	"RG"
"organoid2.GGACAAGAGAAGCCCA"	"RG"
"organoid2.TGTGTTTGTCTTGTCC"	"RG"
"organoid2.GCGACCATCCTGTAGA"	"Cycling"
"organoid2.AACTCAGAGCTTTGGT"	"Cycling"
"organoid2.CCAGCGAGTTCGCGAC"	"Cycling"
"organoid2.GTCAAGTCACTCTGTC"	"Cycling"
"organoid2.TTGGAACGTGTGGTTT"	"Cycling"
"organoid2.AAAGCAAAGTGAAGAG"	"Cycling"
"organoid2.CAGCTGGGTACAGTTC"	"Cycling"
"organoid2.CTGCGGAGTTACGACT"	"Cycling"
"organoid2.GGGTCTGCATTCCTGC"	"RG"
"organoid2.ATTACTCTCTGATTCT"	"Cycling"
"organoid2.CAAGAAATCTTGAGAC"	"Cycling"
"organoid2.ATGGGAGTCTATCCCG"	"Cycling"
"organoid2.CTTAGGATCTCGGACG"	"RG"
"organoid2.CAGTAACCATGTTGAC"	"Cycling"
"organoid2.CTGATCCCAAGCCGCT"	"Cycling"
"organoid2.GTCTTCGGTCACAAGG"	"Cycling"
"organoid2.TACTCGCTCCAGATCA"	"Cycling"
"organoid2.CACCAGGTCATTGCCC"	"Cycling"
"organoid2.TTCTCCTAGATGCGAC"	"RG"
"organoid2.TCGAGGCCAGCCACCA"	"RG"
"organoid2.ACTTGTTTCTAACTGG"	"Cycling"
"organoid2.CTAGTGATCATGGTCA"	"RG"
"organoid2.GTAGTCATCCACGAAT"	"RG"
"organoid2.TTTACTGCATGCAATC"	"RG"
"organoid2.GAACCTAAGACGCACA"	"Cycling"
"organoid2.TGAAAGAGTTACGGAG"	"Cycling"
"organoid2.CAGGTGCCACGTCTCT"	"Cycling"
"organoid2.AGGTCATCATTACGAC"	"Cycling"
"organoid2.CGATTGAGTAAATACG"	"RG"
"organoid2.GGCTGGTAGCGCTTAT"	"RG"
"organoid2.AGGCCACTCGTGGGAA"	"Cycling"
"organoid2.CCTTTCTAGATCACGG"	"Cycling"
"organoid2.CCACGGACATCCGTGG"	"RG"
"organoid2.TGACGGCAGTGTCCAT"	"RG"
"organoid2.GGAGCAACACACGCTG"	"Cycling"
"organoid2.GCTGGGTGTTATCCGA"	"Cycling"
"organoid2.ATAACGCGTCATCCCT"	"Cycling"
"organoid2.TCTTCGGTCTGCTGTC"	"RG"
"organoid2.CCTACCAGTACCTACA"	"RG"
"organoid2.CACAGTACATGCCTAA"	"RG"
"organoid2.TGTCCCAGTGTGACCC"	"RG"
"organoid2.CGAATGTTCATTTGGG"	"Cycling"
"organoid2.ACGTCAATCACTATTC"	"RG"
"organoid2.TTCTACACACTTACGA"	"Cycling"
"organoid2.CTACATTGTGGCCCTA"	"RG"
"organoid2.GTCCTCAGTACATGTC"	"Cycling"
"organoid2.CGTGTCTAGAGAACAG"	"RG"
"organoid2.CCATGTCAGTGAACAT"	"Cycling"
"organoid2.CTCTGGTTCACGAAGG"	"Cycling"
"organoid2.CGGAGCTCAACGATCT"	"RG"
"organoid2.AGCTCCTAGAGCTGGT"	"Cycling"
"organoid2.CCCAGTTAGGATGCGT"	"RG"
"organoid2.TCGAGGCCACTTGGAT"	"RG"
"organoid2.ACATACGCAGATCTGT"	"RG"
"organoid2.TATGCCCGTGTTGAGG"	"RG"
"organoid2.ATCCACCGTCATATCG"	"Cycling"
"organoid2.CGTCTACCAGCTGTAT"	"RG"
"organoid2.GACAGAGGTTCAGCGC"	"RG"
"organoid2.TGCGCAGCATCCGTGG"	"Cycling"
"organoid2.ACACCAACATAACCTG"	"Cycling"
"organoid2.AGACGTTGTCGCTTCT"	"RG"
"organoid2.CTCGTCATCGTTACGA"	"RG"
"organoid2.GGGAATGGTGATAAAC"	"RG"
"organoid2.ACGGAGAAGAGTACAT"	"Cycling"
"organoid2.GACTACAAGCAGGTCA"	"Cycling"
"organoid2.CATGACATCGCCTGTT"	"RG"
"organoid2.TCAGGTAAGACTGGGT"	"RG"
"organoid2.TCCCGATTCGCATGGC"	"RG"
"organoid2.GCTGCGACATTGCGGC"	"RG"
"organoid2.GTCATTTGTTGTGGAG"	"RG"
"organoid2.GTATCTTAGGCAGGTT"	"RG"
"organoid2.TCACGAAGTCAGAAGC"	"Cycling"
"organoid2.CGATGTATCATCGCTC"	"Cycling"
"organoid2.GTGCGGTAGGAGCGTT"	"RG"
"organoid2.GGTGCGTTCGTCTGAA"	"RG"
"organoid2.GCATGTAGTATAGGGC"	"Cycling"
"organoid2.CTGATCCGTCCGTGAC"	"Cycling"
"organoid2.CGACTTCAGACTGTAA"	"Cycling"
"organoid2.GCGACCATCAACCAAC"	"Cycling"
"organoid2.TCAGGATTCATCGCTC"	"RG"
"organoid2.TCGTACCCACGCGAAA"	"Cycling"
"organoid2.GGCGTGTCAAAGGTGC"	"RG"
"organoid2.ACCCACTGTAGCCTCG"	"RG"
"organoid2.GACGTGCCAAGACACG"	"RG"
"organoid2.TCTGGAATCTATCGCC"	"RG"
"organoid2.GGGTTGCAGTCGTTTG"	"RG"
"organoid2.CAGCTAAAGGATGGTC"	"RG"
"organoid2.TGATTTCGTACATGTC"	"Cycling"
"organoid2.CGCTGGAGTAGAAGGA"	"RG"
"organoid2.ATTTCTGGTCAGAAGC"	"Cycling"
"organoid2.CGCTGGAAGAGTCGGT"	"Cycling"
"organoid2.GTCTCGTCAACACCCG"	"Cycling"
"organoid2.GATCAGTAGTGGACGT"	"Cycling"
"organoid2.CGTCAGGGTAAATACG"	"RG"
"organoid2.CTACATTTCTACCAGA"	"RG"
"organoid2.GGGAGATGTGTTTGTG"	"Cycling"
"organoid2.CGGACACAGACTACAA"	"Cycling"
"organoid2.AACTCTTAGTCATGCT"	"Cycling"
"organoid2.AGTAGTCGTCAATACC"	"Cycling"
"organoid2.GAATGAAGTGACCAAG"	"RG"
"organoid2.CATCAGATCTTCGGTC"	"Cycling"
"organoid2.AAGCCGCCACGGCCAT"	"RG"
"organoid2.ACGCAGCAGTCCCACG"	"Cycling"
"organoid2.TCAGATGGTACTTCTT"	"Cycling"
"organoid2.TTTCCTCGTCTCAACA"	"Cycling"
"organoid2.CTGCCTAAGTGTACTC"	"RG"
"organoid2.TACTCATTCAAGATCC"	"RG"
"organoid2.GTGCAGCGTGCCTGCA"	"RG"
"organoid2.CACCTTGGTCATTAGC"	"RG"
"organoid2.ATCGAGTAGTTATCGC"	"RG"
"organoid2.CTGAAACCAAGACGTG"	"RG"
"organoid2.CATATGGTCAGCTCGG"	"RG"
"organoid2.GTGGGTCGTCCAGTGC"	"Cycling"
"organoid2.CACCTTGCACGTGAGA"	"Cycling"
"organoid2.CATCGAAAGAAGCCCA"	"Cycling"
"organoid2.GGGTTGCTCAGTTCGA"	"RG"
"organoid2.GGAACTTAGGACAGCT"	"Cycling"
"organoid2.GCGCAACCATGTCCTC"	"Cycling"
"organoid2.TGAGAGGGTAGCAAAT"	"RG"
"organoid2.GATCAGTAGAAGGGTA"	"RG"
"organoid2.GCGCGATGTCGTCTTC"	"RG"
"organoid2.ACCGTAACAAATACAG"	"Cycling"
"organoid2.CGTGAGCTCGTATCAG"	"RG"
"organoid2.TATTACCTCGGCTTGG"	"RG"
"organoid2.TCTGAGATCAAACGGG"	"RG"
"organoid2.TTGGAACTCCAAACTG"	"RG"
"organoid2.GGTGTTAGTTGTGGCC"	"Cycling"
"organoid2.GGTGAAGGTAGGGTAC"	"RG"
"organoid2.TGCTGCTTCAGCTCGG"	"RG"
"organoid2.GTTCTCGCATTAACCG"	"Cycling"
"organoid2.CGTTCTGAGAGATGAG"	"RG"
"organoid2.ACACCAATCACCTCGT"	"Cycling"
"organoid2.AACGTTGAGGGTGTGT"	"Cycling"
"organoid2.TGGGAAGAGGCGCTCT"	"Cycling"
"organoid2.CGTTCTGAGGAGTAGA"	"RG"
"organoid2.TATCAGGTCCCAAGAT"	"RG"
"organoid2.CGATGGCAGTTAAGTG"	"Cycling"
"organoid2.TATGCCCAGTTTAGGA"	"RG"
"organoid2.TCTCATAGTGCCTGTG"	"RG"
"organoid2.TCCACACAGTACGTAA"	"RG"
"organoid2.ACGATACGTTCCGGCA"	"Cycling"
"organoid2.AAGCCGCCATTCCTCG"	"RG"
"organoid2.GTGAAGGGTCCGCTGA"	"RG"
"organoid2.TCAATCTGTGACAAAT"	"RG"
"organoid2.CGAGAAGAGTTAGCGG"	"Cycling"
"organoid2.ACGATGTAGGCAAAGA"	"RG"
"organoid2.TGACGGCCATTTGCTT"	"RG"
"organoid2.GACTAACAGGTGCACA"	"RG"
"organoid2.CGGCTAGGTCTCATCC"	"Cycling"
"organoid2.CGAGCCAAGCCCAGCT"	"Cycling"
"organoid2.CCTAAAGGTTAAAGAC"	"RG"
"organoid2.GCTTCCAGTAGAGCTG"	"Cycling"
"organoid2.CCATTCGTCCAGTATG"	"RG"
"organoid2.TACTTACAGTTGTCGT"	"Cycling"
"organoid2.GTCGTAAGTGGCAAAC"	"RG"
"organoid2.GTACGTAGTTTGTTTC"	"RG"
"organoid2.ATGTGTGTCCTACAGA"	"Cycling"
"organoid2.CTCGTACAGCATCATC"	"RG"
"organoid2.GACACGCTCACTATTC"	"RG"
"organoid2.GCTTGAAGTGCGATAG"	"Cycling"
"organoid2.CAAGGCCGTCATCGGC"	"RG"
"organoid2.CGAGCACGTTTGTGTG"	"RG"
"organoid2.GGACAAGTCACGATGT"	"Cycling"
"organoid2.GACGGCTAGATTACCC"	"RG"
"organoid2.AAGGCAGAGCCAGAAC"	"RG"
"organoid2.TTGGAACCAGTCGTGC"	"RG"
"organoid2.GCCTCTAGTGCGATAG"	"RG"
"organoid2.AAGGCAGGTTGTCTTT"	"RG"
"organoid2.ATCTACTCAGCCACCA"	"RG"
"organoid2.CAGCAGCGTAGCACGA"	"Cycling"
"organoid2.CTGATAGAGCGCCTTG"	"Cycling"
"organoid2.CGTTCTGAGAGTCGGT"	"RG"
"organoid2.CCATTCGGTACCGAGA"	"RG"
"organoid2.CGGACGTGTAAACACA"	"RG"
"organoid2.TTCCCAGGTTGTACAC"	"RG"
"organoid2.CGAGAAGTCGGCTTGG"	"RG"
"organoid2.ATGTGTGTCATGTCTT"	"RG"
"organoid2.CGACTTCCATATACGC"	"RG"
"organoid2.GCGACCAAGCGTTCCG"	"Cycling"
"organoid2.ATGGGAGCATTACGAC"	"Cycling"
"organoid2.GGCTGGTGTAACGTTC"	"RG"
"organoid2.CAGGTGCAGAGCCTAG"	"Cycling"
"organoid2.CACCAGGGTCGTTGTA"	"Cycling"
"organoid2.ATTTCTGAGTGGTAGC"	"RG"
"organoid2.CCAGCGAGTGGGTCAA"	"RG"
"organoid2.ATGAGGGAGCGATTCT"	"RG"
"organoid2.CGTAGCGCAATAAGCA"	"Cycling"
"organoid2.TTTCCTCGTTGGTTTG"	"RG"
"organoid2.GTGCTTCAGGACTGGT"	"RG"
"organoid2.AGCGGTCTCCTCTAGC"	"RG"
"organoid2.AGATTGCTCCCAACGG"	"RG"
"organoid2.AAGTCTGGTCTTTCAT"	"Cycling"
"organoid2.GGCCGATTCTTGTATC"	"RG"
"organoid2.TTATGCTTCTACTTAC"	"RG"
"organoid2.AACTCCCCATACTACG"	"RG"
"organoid2.CGATGGCTCGCTGATA"	"Cycling"
"organoid2.CAGTAACGTTTGCATG"	"RG"
"organoid2.ATTGGACAGCATGGCA"	"RG"
"organoid2.GGGAGATCAGGAACGT"	"RG"
"organoid2.GTAGGCCGTGCGCTTG"	"RG"
"organoid2.GTGTTAGTCACTTACT"	"RG"
"organoid2.TTCTACATCGAGGTAG"	"RG"
"organoid2.CTTAACTAGTACGATA"	"RG"
"organoid2.TCGTAGAAGTCCGTAT"	"RG"
"organoid2.CATATTCCAATCGAAA"	"Cycling"
"organoid2.TCATTTGGTATAGGTA"	"Cycling"
"organoid2.CGATTGACAAATTGCC"	"RG"
"organoid2.ATAAGAGAGGAGTCTG"	"Cycling"
"organoid2.CGTTCTGGTCAACATC"	"RG"
"organoid2.CTCGAAAGTAGCTTGT"	"RG"
"organoid2.CTACACCTCATCACCC"	"Cycling"
"organoid2.CTTTGCGAGCACACAG"	"RG"
"organoid2.TACCTATGTGCGGTAA"	"RG"
"organoid2.TTGAACGGTCTGCGGT"	"RG"
"organoid2.ACTTACTCACCGTTGG"	"RG"
"organoid2.GGGTTGCAGGCTAGGT"	"Cycling"
"organoid2.CCGTGGATCACCCTCA"	"Cycling"
"organoid2.GAAGCAGAGCGCTTAT"	"RG"
"organoid2.CACACCTGTCACCTAA"	"RG"
"organoid2.CGCGTTTAGTGTGGCA"	"RG"
"organoid2.CACAGTATCACAGGCC"	"RG"
"organoid2.TTCTACAGTCCATCCT"	"RG"
"organoid2.CCTCAGTCACAGACTT"	"RG"
"organoid2.CTTTGCGAGCTATGCT"	"RG"
"organoid2.AGAGTGGGTAAAGGAG"	"RG"
"organoid2.CATATTCGTCACTTCC"	"RG"
"organoid2.CATCGGGGTGCTTCTC"	"RG"
"organoid2.ATTGGTGCACAAGACG"	"RG"
"organoid2.CTCTACGCATGTCTCC"	"RG"
"organoid2.GGTGAAGAGCGTGTCC"	"RG"
"organoid2.CACACCTAGAATTCCC"	"RG"
"organoid2.TTAGGACCAGCCTTTC"	"RG"
"organoid2.GTCATTTTCGTTTGCC"	"RG"
"organoid2.CTTCTCTTCAAGGTAA"	"Cycling"
"organoid2.CTGCGGAAGCGATTCT"	"RG"
"organoid2.AGCGTCGTCTTGCCGT"	"Cycling"
"organoid2.CAGTAACCAAAGCAAT"	"Cycling"
"organoid2.CTACCCATCAACCAAC"	"RG"
"organoid2.TTAGGACTCAGTGCAT"	"RG"
"organoid2.GGTGTTAAGGTAGCTG"	"RG"
"organoid2.ACTTTCAGTTTACTCT"	"RG"
"organoid2.AACTCAGTCTCTGCTG"	"RG"
"organoid2.AATCCAGAGAGTCGGT"	"RG"
"organoid2.CATCAAGTCTGTACGA"	"RG"
"organoid2.CAAGGCCCACCAACCG"	"RG"
"organoid2.ATGGGAGAGGTGGGTT"	"RG"
"organoid2.AACGTTGTCGGAGGTA"	"RG"
"organoid2.CCGGGATGTATTACCG"	"RG"
"organoid2.CCCAATCCAGCTGCTG"	"RG"
"organoid2.GGAATAAGTACTTGAC"	"RG"
"organoid2.ACGAGCCGTGTCTGAT"	"RG"
"organoid2.CTACCCAAGGTGCAAC"	"RG"
"organoid2.AGCCTAAAGCGTTGCC"	"RG"
"organoid2.ATCTACTTCTAGCACA"	"RG"
"organoid2.GATCGCGTCCTAGGGC"	"RG"
"organoid2.TTGACTTAGCCAGGAT"	"RG"
"organoid2.TAGCCGGTCCCAAGAT"	"RG"
"organoid2.CTAACTTGTGTCAATC"	"RG"
"organoid2.ATAGACCTCCCTAACC"	"Cycling"
"organoid2.CTCACACTCTCAACTT"	"RG"
"organoid2.AGGCCGTCAAGTAATG"	"RG"
"organoid2.TAGAGCTGTGACAAAT"	"RG"
"organoid2.TCCACACCACTATCTT"	"RG"
"organoid2.CTGAAACCAGCCTTGG"	"RG"
"organoid2.CTAGAGTCAAACGCGA"	"RG"
"organoid2.CTAATGGTCCCAACGG"	"RG"
"organoid2.TCGAGGCGTGACTCAT"	"RG"
"organoid2.TCTTCGGGTTCCCTTG"	"RG"
"organoid2.CTTCTCTAGATAGGAG"	"RG"
"organoid2.AGATTGCCATAGTAAG"	"RG"
"organoid2.GGGTTGCTCCCAAGTA"	"RG"
"organoid2.GGGCATCTCCGAATGT"	"RG"
"organoid2.TTGCGTCAGAGTAATC"	"RG"
"organoid2.TGGTTCCCATGGGAAC"	"RG"
"organoid2.CATGACAGTCACTTCC"	"RG"
"organoid2.TCATTACTCGGGAGTA"	"RG"
"organoid2.AGTCTTTGTTAAGAAC"	"RG"
"organoid2.ATCCGAAAGTGAACGC"	"RG"
"organoid2.CTCGTACCAGTGACAG"	"RG"
"organoid2.CACAGGCGTAGTGAAT"	"RG"
"organoid2.GATGAGGCAATGTTGC"	"RG"
"organoid2.CATATGGAGACGCACA"	"RG"
"organoid2.CTAGAGTCAGTCACTA"	"RG"
"organoid2.TCATTACGTCTAGAGG"	"RG"
"organoid2.GTTCGGGAGTTTAGGA"	"RG"
"organoid2.ATCGAGTTCCCGGATG"	"RG"
"organoid2.GATCTAGCACGAAACG"	"RG"
"organoid2.TTCTTAGAGTCCCACG"	"RG"
"organoid2.CGTCACTTCATGCAAC"	"RG"
"organoid2.AACACGTCAAAGTGCG"	"RG"
"organoid2.GATCGCGGTTATTCTC"	"RG"
"organoid2.CGAGCACGTCAGAATA"	"RG"
"organoid2.ATTACTCCAGCTGGCT"	"RG"
"organoid2.AGACGTTGTAGAGCTG"	"RG"
"organoid2.CTCTAATAGTCGCCGT"	"RG"
"organoid2.GATGAGGGTCGCCATG"	"RG"
"organoid2.AGCTCCTAGATGAGAG"	"RG"
"organoid2.GGTGAAGGTCTGATTG"	"Cycling"
"organoid2.CATCAGAAGATGTGGC"	"RG"
"organoid2.CGCTATCCAATCTGCA"	"RG"
"organoid2.CGGAGCTGTCTAACGT"	"RG"
"organoid2.CGAATGTCACGTTGGC"	"RG"
"organoid2.CCACGGAGTTATCGGT"	"RG"
"organoid2.GTGTTAGAGCCACGTC"	"RG"
"organoid2.CCAGCGAAGCTAACTC"	"RG"
"organoid2.TTCTCCTTCACGATGT"	"RG"
"organoid2.TACGGGCCAAGAGTCG"	"Cycling"
"organoid2.AGCGTCGAGCCATCGC"	"RG"
"organoid2.GTAGTCAAGTGTCCAT"	"RG"
"organoid2.GACTAACGTCGCTTTC"	"RG"
"organoid2.CAAGTTGGTCCGTGAC"	"RG"
"organoid2.CGTTGGGCAGGATTGG"	"RG"
"organoid2.GGGAGATGTAAGTGGC"	"RG"
"organoid2.TCTTCGGCAAAGGAAG"	"RG"
"organoid2.ATGGGAGAGCCTCGTG"	"RG"
"organoid2.AGGCCACTCTCTGTCG"	"RG"
"organoid2.ATTCTACCATTGCGGC"	"RG"
"organoid2.AAGGTTCGTACAGTTC"	"RG"
"organoid2.GTCCTCAGTCGCGTGT"	"Cycling"
"organoid2.GTCACGGAGGACAGCT"	"RG"
"organoid2.TATCAGGCATCGGTTA"	"RG"
"organoid2.CTTGGCTTCAGGTTCA"	"RG"
"organoid2.GCTTCCAGTATAATGG"	"RG"
"organoid2.GTGCATAGTTACCGAT"	"RG"
"organoid2.AAAGATGAGTCGATAA"	"RG"
"organoid3.GTATTCTAGGAATTAC"	"Cycling"
"organoid3.TGCACCTAGAGTGAGA"	"Cycling"
"organoid3.GAAGCAGAGCTCAACT"	"Cycling"
"organoid3.TGCTGCTAGGGCACTA"	"RG"
"organoid3.CATATGGGTACAAGTA"	"Cycling"
"organoid3.AACCATGAGAGGTACC"	"RG"
"organoid3.TAGTGGTTCTTCCTTC"	"Cycling"
"organoid3.TTATGCTTCGTTTGCC"	"Cycling"
"organoid3.GTCAAGTCACGACGAA"	"Cycling"
"organoid3.TACAGTGTCCCTTGTG"	"Cycling"
"organoid3.ACAGCCGCAATGAAAC"	"Cycling"
"organoid3.CTCGAAATCCGTACAA"	"RG"
"organoid3.CTCGAAACAGCCTTGG"	"Cycling"
"organoid3.AGCGGTCTCGTCCAGG"	"Cycling"
"organoid3.TCATTACCACATTCGA"	"Cycling"
"organoid3.TATTACCAGATGGGTC"	"Cycling"
"organoid3.TGACAACGTTACGTCA"	"RG"
"organoid3.TCAATCTCATACGCCG"	"RG"
"organoid3.TAAACCGTCATGTCCC"	"Cycling"
"organoid3.TTAGGACTCTCTTGAT"	"RG"
"organoid3.CTGATAGTCTATGTGG"	"RG"
"organoid3.CCCTCCTAGGTGGGTT"	"Cycling"
"organoid3.CAAGATCCAGCCTATA"	"Cycling"
"organoid3.CGTCAGGCATCCTTGC"	"RG"
"organoid3.ACCGTAAGTATATGAG"	"Cycling"
"organoid3.CTGATCCTCGACCAGC"	"Cycling"
"organoid3.TCTCATAAGCTAACAA"	"Cycling"
"organoid3.TACTTGTTCTTGTCAT"	"Cycling"
"organoid3.CTCGGAGAGTTCGATC"	"Cycling"
"organoid3.TACACGAAGTGGTAAT"	"Cycling"
"organoid3.GATGAAATCAAAGACA"	"RG"
"organoid3.TCAATCTGTGATAAGT"	"Cycling"
"organoid3.AAGGAGCGTACAGTGG"	"RG"
"organoid3.CGTGTAAAGGTGCTAG"	"Cycling"
"organoid3.CATCAGACATCGATGT"	"Cycling"
"organoid3.GCAATCATCTTCCTTC"	"Cycling"
"organoid3.TAGAGCTAGATGTGTA"	"Cycling"
"organoid3.CCGTGGATCAAACCGT"	"Cycling"
"organoid3.CGAGCCACAGGCGATA"	"Cycling"
"organoid3.TTAGTTCGTCACCCAG"	"Cycling"
"organoid3.TGGACGCAGAGACGAA"	"Cycling"
"organoid3.GTCATTTAGCTGGAAC"	"RG"
"organoid3.TAGAGCTAGTGACTCT"	"Cycling"
"organoid3.TCGTAGAAGCACAGGT"	"Cycling"
"organoid3.CCCAGTTGTAAAGTCA"	"RG"
"organoid3.ACTGAACTCCGAAGAG"	"Cycling"
"organoid3.TTTATGCGTTCCACGG"	"Cycling"
"organoid3.AAATGCCAGAGACTAT"	"Cycling"
"organoid3.TCAGATGAGCTGTCTA"	"RG"
"organoid3.TCTATTGAGCAGCCTC"	"RG"
"organoid3.ACGGCCAGTAGCTTGT"	"Cycling"
"organoid3.GTCGGGTTCCGTTGCT"	"Cycling"
"organoid3.ATTCTACCATGTCGAT"	"Cycling"
"organoid3.TAAGCGTTCCGATATG"	"Cycling"
"organoid3.TGTATTCTCGGATGGA"	"Cycling"
"organoid3.TGGTTCCAGTACGTTC"	"RG"
"organoid3.GGACATTGTAGCGCTC"	"Cycling"
"organoid3.ACCTTTAAGTCGCCGT"	"Cycling"
"organoid3.TAGTTGGCACCTATCC"	"RG"
"organoid3.GATGAAATCCGAATGT"	"Cycling"
"organoid3.ACATGGTTCAGCGATT"	"Cycling"
"organoid3.TGATTTCAGTACGATA"	"Cycling"
"organoid3.TCACAAGAGCACCGTC"	"Cycling"
"organoid3.CACAAACGTCGACTAT"	"Cycling"
"organoid3.TGGTTAGTCACAGTAC"	"RG"
"organoid3.AGCTTGAAGGACCACA"	"Cycling"
"organoid3.CTAGCCTTCTTGCCGT"	"Cycling"
"organoid3.TGCGCAGTCTAACCGA"	"Cycling"
"organoid3.CATATTCGTCCTCTTG"	"RG"
"organoid3.GGGTCTGAGGCTAGCA"	"Cycling"
"organoid3.CTTTGCGGTCCGTCAG"	"Cycling"
"organoid3.CTGAAGTCACTTGGAT"	"Cycling"
"organoid3.TTAGGCATCTTTAGGG"	"Cycling"
"organoid3.ATCCACCCAATAAGCA"	"Cycling"
"organoid3.CAACCTCAGGTGCACA"	"Cycling"
"organoid3.GGTATTGAGCGATAGC"	"RG"
"organoid3.CCCAGTTGTCGTCTTC"	"Cycling"
"organoid3.GCTCCTAAGTACGTTC"	"Cycling"
"organoid3.AGATCTGTCGCTGATA"	"Cycling"
"organoid3.ACGGAGAAGTGGCACA"	"Cycling"
"organoid3.CCACCTAGTCATGCCG"	"RG"
"organoid3.TACTTACTCATTGCCC"	"RG"
"organoid3.CGTAGCGCATATGCTG"	"Cycling"
"organoid3.CTCGAAACACTGTTAG"	"Cycling"
"organoid3.GACACGCAGTACGCCC"	"RG"
"organoid3.ATCATGGCATATACCG"	"Cycling"
"organoid3.CAGCCGACAGGATCGA"	"RG"
"organoid3.GTACGTATCGACGGAA"	"Cycling"
"organoid3.CTCGGGATCCATGCTC"	"Cycling"
"organoid3.GTTCTCGTCTGCTGCT"	"Cycling"
"organoid3.ACACTGAAGGCTCTTA"	"Cycling"
"organoid3.ACTGAACTCCGTACAA"	"Cycling"
"organoid3.CAAGTTGAGACCTAGG"	"RG"
"organoid3.TGCGTGGAGGTTACCT"	"Cycling"
"organoid3.TCAATCTGTCCGACGT"	"Cycling"
"organoid3.CCCATACAGCTAGCCC"	"Cycling"
"organoid3.CCTTTCTAGGGTATCG"	"Cycling"
"organoid3.AAAGTAGTCTTCGGTC"	"RG"
"organoid3.AACTCAGGTTACGGAG"	"Cycling"
"organoid3.GGGCACTGTGTAATGA"	"Cycling"
"organoid3.CATCAGAGTTCTCATT"	"RG"
"organoid3.CGGACTGGTACCGGCT"	"RG"
"organoid3.CAGCCGAGTTCGCGAC"	"Cycling"
"organoid3.GTTCTCGAGGGCTTCC"	"Cycling"
"organoid3.TGCCCTACAGATAATG"	"Cycling"
"organoid3.GATTCAGTCAAGAAGT"	"RG"
"organoid3.CAAGAAAGTGATAAAC"	"Cycling"
"organoid3.CGCTATCAGATCGATA"	"Cycling"
"organoid3.CGAGAAGAGACTACAA"	"RG"
"organoid3.GAACGGATCGAATCCA"	"Cycling"
"organoid3.TCTATTGTCCAGTATG"	"Cycling"
"organoid3.TCAGCTCCACCTCGTT"	"Cycling"
"organoid3.AAGGAGCGTTGTGGCC"	"Cycling"
"organoid3.GCTCTGTAGGCTAGAC"	"RG"
"organoid3.CAAGATCGTGTGTGCC"	"Cycling"
"organoid3.AACTTTCGTTGTCGCG"	"Cycling"
"organoid3.TACGGATAGAATAGGG"	"Cycling"
"organoid3.CAGCCGAAGAGTCGGT"	"Cycling"
"organoid3.AGGCCACAGTTTAGGA"	"Cycling"
"organoid3.CAGGTGCAGAAGAAGC"	"Cycling"
"organoid3.CGCTTCAAGCCTCGTG"	"Cycling"
"organoid3.TGACGGCAGATGTAAC"	"RG"
"organoid3.AGCTTGAAGGTAAACT"	"RG"
"organoid3.TAGACCAGTTCCTCCA"	"Cycling"
"organoid3.AGTTGGTGTCCCTTGT"	"Cycling"
"organoid3.AACCATGTCGTCCGTT"	"RG"
"organoid3.CGTCCATTCATGGTCA"	"Cycling"
"organoid3.CATGCCTGTAGCGCTC"	"RG"
"organoid3.CTCGTCAGTCAGCTAT"	"RG"
"organoid3.ACGGGTCCAGGGCATA"	"RG"
"organoid3.CCAGCGAGTATATGAG"	"Cycling"
"organoid3.TCGTACCTCTCTAGGA"	"RG"
"organoid3.CACAGGCAGATATACG"	"Cycling"
"organoid3.TTATGCTGTTGACGTT"	"Cycling"
"organoid3.CGTGTCTCAGCTATTG"	"Cycling"
"organoid3.AAGGAGCGTACTCTCC"	"RG"
"organoid3.ACTTGTTGTAGATTAG"	"RG"
"organoid3.GTATCTTTCCAGTAGT"	"RG"
"organoid3.CATATGGAGGCCATAG"	"Cycling"
"organoid3.ATAGACCTCCCTTGTG"	"RG"
"organoid3.GTCCTCACAGGAATGC"	"RG"
"organoid3.ATAAGAGAGCACACAG"	"Cycling"
"organoid3.TTCTACAGTACAGCAG"	"RG"
"organoid3.GCTGCAGAGCCAGAAC"	"RG"
"organoid3.CGAGCCAGTCTAGTGT"	"Cycling"
"organoid3.CAACTAGTCGAATCCA"	"RG"
"organoid3.GGACAAGCAGTAAGAT"	"Cycling"
"organoid3.ACATCAGGTTTGACTG"	"Cycling"
"organoid3.GCTCTGTGTGTGACCC"	"RG"
"organoid3.GCATACACAGCCTGTG"	"Cycling"
"organoid3.CCTCAGTTCCTATTCA"	"RG"
"organoid3.AGGTCATCACGTCAGC"	"RG"
"organoid3.ATGCGATTCCACGTGG"	"Cycling"
"organoid3.TGACGGCAGGAGTACC"	"Cycling"
"organoid3.GTGTTAGTCCACGACG"	"Cycling"
"organoid3.TCTGGAAGTCTTCGTC"	"RG"
"organoid3.GCTGCAGCATGTAGTC"	"RG"
"organoid3.TATCAGGAGCGTTCCG"	"Cycling"
"organoid3.CCACCTAAGTGGACGT"	"Cycling"
"organoid3.AGGCCACGTACCGCTG"	"Cycling"
"organoid3.GCAAACTTCACATAGC"	"Cycling"
"organoid3.CCTAAAGTCTCACATT"	"Cycling"
"organoid3.TGCTACCCACGAAATA"	"RG"
"organoid3.ACGGGCTCAGCTCGCA"	"Cycling"
"organoid3.AGGGTGAAGGGTCTCC"	"RG"
"organoid3.CCTATTATCCCAGGTG"	"Cycling"
"organoid3.CGTTCTGTCGGAAATA"	"Cycling"
"organoid3.TTCTCAAGTACAGTTC"	"RG"
"organoid3.CTGTTTATCCGTACAA"	"Cycling"
"organoid3.AACTGGTTCGGATGTT"	"RG"
"organoid3.TACAGTGCACGTGAGA"	"Cycling"
"organoid3.GATCAGTGTCAGTGGA"	"Cycling"
"organoid3.TCAGGTAAGTGACTCT"	"RG"
"organoid3.AGGGAGTTCGCACTCT"	"RG"
"organoid3.ACATGGTTCGGCATCG"	"RG"
"organoid3.CCACGGATCATGTCCC"	"RG"
"organoid3.GACTGCGGTGTTTGTG"	"Cycling"
"organoid3.AAGTCTGGTGACAAAT"	"Cycling"
"organoid3.CGCTATCCACACCGCA"	"RG"
"organoid3.GTAACTGTCAGAGCTT"	"Cycling"
"organoid3.GACCTGGAGCTCTCGG"	"Cycling"
"organoid3.CCGTACTGTCCGAATT"	"Cycling"
"organoid3.GCAGCCAGTCTTGATG"	"RG"
"organoid3.TACTTGTCACCTCGGA"	"Cycling"
"organoid3.GCTGCAGCATGGATGG"	"RG"
"organoid3.GAGTCCGAGACGACGT"	"RG"
"organoid3.GTCGTAAAGTACGATA"	"RG"
"organoid3.TGGGAAGCATATGGTC"	"Cycling"
"organoid3.ATTGGTGGTTGACGTT"	"RG"
"organoid3.CGTCAGGGTCTAAAGA"	"RG"
"organoid3.GCGACCAAGTCATGCT"	"Cycling"
"organoid3.GTCACAATCTTTAGGG"	"RG"
"organoid3.CAAGTTGAGAGTACCG"	"Cycling"
"organoid3.ATAGACCAGCTAAACA"	"Cycling"
"organoid3.ATGAGGGTCCAAGTAC"	"Cycling"
"organoid3.TATTACCAGCGCCTTG"	"Cycling"
"organoid3.AAGGAGCGTCATCCCT"	"RG"
"organoid3.CCCTCCTTCCTATTCA"	"Cycling"
"organoid3.TTCGGTCTCCAATGGT"	"RG"
"organoid3.TCAGCAAAGGCACATG"	"Cycling"
"organoid3.CACACAACAGAGCCAA"	"Cycling"
"organoid3.GGACAAGTCTCTAGGA"	"Cycling"
"organoid3.GGCTCGACAGGTTTCA"	"RG"
"organoid3.CACACTCGTGCGCTTG"	"Cycling"
"organoid3.ATTCTACGTCCAGTGC"	"RG"
"organoid3.GACACGCCACGGACAA"	"Cycling"
"organoid3.GATCGATGTCCTCTTG"	"RG"
"organoid3.TCGCGAGTCTGCTGCT"	"RG"
"organoid3.GGGCACTAGGAGTAGA"	"RG"
"organoid3.GTACTTTGTCAGAATA"	"RG"
"organoid3.GGGACCTTCGGATGGA"	"RG"
"organoid3.CCACCTAAGAGCAATT"	"RG"
"organoid3.GGAGCAAGTAAGGGCT"	"Cycling"
"organoid3.CGCTATCAGTCGATAA"	"Cycling"
"organoid3.GGAAAGCTCACAGTAC"	"Cycling"
"organoid3.CGTCCATGTTAGATGA"	"Cycling"
"organoid3.CCAATCCAGACTAGAT"	"RG"
"organoid3.TGCTACCTCCCATTAT"	"Cycling"
"organoid3.CCGTGGAAGGCTAGGT"	"Cycling"
"organoid3.CATGACACATGCTGGC"	"RG"
"organoid3.GTCTTCGAGGCAGTCA"	"Cycling"
"organoid3.CGATTGATCCTCGCAT"	"Cycling"
"organoid3.AGCGGTCAGCGATGAC"	"RG"
"organoid3.CACACCTAGAATCTCC"	"Cycling"
"organoid3.GCGACCAGTCGATTGT"	"Cycling"
"organoid3.GCCAAATTCCTTAATC"	"Cycling"
"organoid3.GGAAAGCTCCGATATG"	"RG"
"organoid3.CTCCTAGGTATAGGGC"	"RG"
"organoid3.ACATGGTAGCGTTCCG"	"RG"
"organoid3.TTCTTAGAGTGATCGG"	"RG"
"organoid3.CTCGGAGGTTGGTTTG"	"RG"
"organoid3.CGGGTCAAGCCTATGT"	"Cycling"
"organoid3.ATGGGAGGTAGCGATG"	"RG"
"organoid3.GACGTGCCAGGATTGG"	"Cycling"
"organoid3.GGGAGATTCGACAGCC"	"Cycling"
"organoid3.ATGTGTGCAGCTTCGG"	"Cycling"
"organoid3.GAGGTGAGTTGGTGGA"	"RG"
"organoid3.TCCCGATTCCTTGACC"	"RG"
"organoid3.AAATGCCCAGCGATCC"	"Cycling"
"organoid3.AACCGCGGTCCAGTAT"	"RG"
"organoid3.ATCCACCGTGGTCCGT"	"RG"
"organoid3.ACGGGTCGTATCGCAT"	"Cycling"
"organoid3.CGTAGGCTCTTGAGGT"	"Cycling"
"organoid3.TCAGCAACAAGCTGTT"	"Cycling"
"organoid3.GTACTTTCAAGAGTCG"	"RG"
"organoid3.ACACCGGCATCACAAC"	"RG"
"organoid3.CCGGGATTCTTGCATT"	"Cycling"
"organoid3.AACTCAGCATAAGACA"	"RG"
"organoid3.TCTATTGTCTATCCTA"	"Cycling"
"organoid3.ACGAGCCGTAAGGGAA"	"RG"
"organoid3.ACCAGTACAGCTCGCA"	"RG"
"organoid3.GCATGCGGTCTGGTCG"	"Cycling"
"organoid3.AGCGGTCCAGGCGATA"	"Cycling"
"organoid3.CATCGAAAGCCGCCTA"	"Cycling"
"organoid3.CAGCAGCAGTGGGATC"	"RG"
"organoid3.CGTTCTGCACGCCAGT"	"Cycling"
"organoid3.AGTGAGGCAGTCGATT"	"RG"
"organoid3.TGCACCTCAGATCTGT"	"Cycling"
"organoid3.ACTTGTTCATCTATGG"	"Cycling"
"organoid3.TGCCCATCAATGTAAG"	"RG"
"organoid3.GCGAGAAGTTTCGCTC"	"RG"
"organoid3.CGGAGCTCACCGAAAG"	"Cycling"
"organoid3.TTTGCGCGTAGCACGA"	"RG"
"organoid3.GCTTGAATCAGAGCTT"	"Cycling"
"organoid3.CAGCGACGTACAGACG"	"Cycling"
"organoid3.GGAGCAATCTCGCTTG"	"Cycling"
"organoid3.TGACTAGGTACCTACA"	"Cycling"
"organoid3.TGGCGCACAGCTGTTA"	"Cycling"
"organoid3.CGTCAGGCAGCCACCA"	"RG"
"organoid3.GATCGATCAGGTCCAC"	"Cycling"
"organoid3.GCATGCGTCTACCAGA"	"Cycling"
"organoid3.ACACCGGTCCTGCCAT"	"Cycling"
"organoid3.GTCACAAAGTTTAGGA"	"RG"
"organoid3.CTAACTTCAAGGTGTG"	"RG"
"organoid3.CATTATCTCATGTCTT"	"Cycling"
"organoid3.GTTACAGAGGCCATAG"	"RG"
"organoid3.GATTCAGTCGCCAGCA"	"Cycling"
"organoid3.CTGATCCCAGCGTTCG"	"RG"
"organoid3.CGATTGAGTTCGTTGA"	"Cycling"
"organoid3.GCTGCTTCACTTCTGC"	"RG"
"organoid3.TTAGGACGTTCCGTCT"	"RG"
"organoid3.ACTTACTAGAGTTGGC"	"RG"
"organoid3.GCATGCGTCGCATGGC"	"RG"
"organoid3.ATGAGGGGTCCATCCT"	"RG"
"organoid3.GCTGCGAGTATCGCAT"	"RG"
"organoid3.ACACCGGCATCGACGC"	"Cycling"
"organoid3.AGGTCATCAATCGAAA"	"RG"
"organoid3.GACTGCGTCGTAGATC"	"Cycling"
"organoid3.CAGTCCTAGTTGAGAT"	"RG"
"organoid3.AGCGGTCGTCACCTAA"	"RG"
"organoid3.TCTTCGGCATATGGTC"	"RG"
"organoid3.GCTGGGTAGATCGATA"	"RG"
"organoid3.CGTTCTGGTGTGCCTG"	"Cycling"
"organoid3.TCTTCGGGTATTCGTG"	"RG"
"organoid3.TGGCTGGAGGGTGTTG"	"RG"
"organoid3.GCGCAGTCATGTCGAT"	"Cycling"
"organoid3.GTGTGCGCACGTCAGC"	"Cycling"
"organoid3.TGCGTGGCATCCTAGA"	"RG"
"organoid3.ACTGTCCCAATCGAAA"	"RG"
"organoid3.TGATTTCAGCTAGTCT"	"RG"
"organoid3.TTTACTGTCTGGCGAC"	"RG"
"organoid3.CTCTAATCAGGATCGA"	"Cycling"
"organoid3.CTTGGCTGTCCGAGTC"	"Cycling"
"organoid3.AAATGCCTCTGTTGAG"	"RG"
"organoid3.TCTGAGAAGCTGAACG"	"RG"
"organoid3.GGGTCTGAGTAGCGGT"	"RG"
"organoid3.GATGAGGCATGGAATA"	"RG"
"organoid3.TGACTAGTCAGTCAGT"	"RG"
"organoid3.ATCCGAATCGGGAGTA"	"RG"
"organoid3.ATAACGCCAAACTGCT"	"Cycling"
"organoid3.TCAGCTCAGGCAGGTT"	"RG"
"organoid3.CAAGATCAGCTGGAAC"	"RG"
"organoid3.CAAGTTGGTGCCTGTG"	"RG"
"organoid3.CGATTGAAGCTAAGAT"	"RG"
"organoid3.ACGGCCAGTAGTGAAT"	"RG"
"organoid3.AGTTGGTAGGCCCGTT"	"RG"
"organoid3.GCGCAACCATTCTTAC"	"Cycling"
"organoid3.GTGAAGGTCCATGCTC"	"RG"
"organoid3.AACCATGTCTGAGGGA"	"RG"
"organoid3.GGCGTGTCAGTCAGAG"	"RG"
"organoid3.GACGGCTTCGAATCCA"	"RG"
"organoid3.CGCTGGACACCGAAAG"	"RG"
"organoid3.GAAGCAGGTGTCAATC"	"RG"
"organoid3.TTTGCGCAGGCATGTG"	"RG"
"organoid3.TCATTTGGTCGAATCT"	"RG"
"organoid3.CTCTAATAGACTGGGT"	"RG"
"organoid3.GCCAAATTCTGATACG"	"RG"
"organoid3.CGGACACTCAGCGACC"	"RG"
"organoid3.CTACACCAGTCCGTAT"	"RG"
"organoid3.ATGTGTGTCGTCCGTT"	"Cycling"
"organoid3.ATGAGGGGTCCAACTA"	"RG"
"organoid3.CTCAGAATCAGCAACT"	"RG"
"organoid3.TTTCCTCAGTCGTTTG"	"RG"
"organoid3.CGCGGTAAGCCTTGAT"	"RG"
"organoid3.AGCGTCGGTCGAGATG"	"RG"
"organoid3.GCTCTGTCAAGCCGCT"	"RG"
"organoid3.CCATGTCCACCCTATC"	"Cycling"
"organoid3.GTAACTGGTCGACTAT"	"RG"
"organoid3.GTAGGCCAGGCAAAGA"	"Cycling"
"organoid3.TTCGAAGGTAAACCTC"	"Cycling"
"organoid3.ACTGCTCCACGTCAGC"	"RG"
"organoid3.TAAACCGAGTAGGCCA"	"RG"
"organoid3.ACCAGTAAGACGACGT"	"RG"
"organoid3.GCGCGATTCGCATGGC"	"Cycling"
"organoid3.TGACTAGAGGATGGTC"	"RG"
"organoid3.ACGAGGACAGGGAGAG"	"RG"
"organoid3.GCAGTTAAGGTGCTAG"	"Cycling"
"organoid3.CTCAGAATCAGATAAG"	"RG"
"organoid3.CACACTCGTCTTGTCC"	"RG"
"organoid3.GGGATGATCGCCAGCA"	"RG"
"organoid3.AGCGGTCAGGCTACGA"	"RG"
"organoid3.CGCGGTACATACCATG"	"RG"
"organoid3.GGACATTTCCTCTAGC"	"RG"
"organoid3.GTTCATTCAAATTGCC"	"RG"
"organoid3.CGAACATCATCCGTGG"	"RG"
"organoid3.TAAGCGTTCTTTAGTC"	"RG"
"organoid3.TTAACTCCAGCGAACA"	"RG"
"organoid3.GAACCTAAGACAAAGG"	"RG"
"organoid3.ACTGAACAGGCTAGCA"	"RG"
"organoid3.TGGTTCCAGGCGTACA"	"Cycling"
"organoid3.GAGGTGAAGACTAGAT"	"RG"
"organoid3.CCGGTAGCACGACTCG"	"RG"
"organoid3.ATGAGGGCATCGGTTA"	"RG"
"organoid3.TGGACGCCACCAGCAC"	"RG"
"organoid3.CCTATTAAGTCTCAAC"	"RG"
"organoid3.TGGCCAGGTCAGAGGT"	"RG"
"organoid3.TTGACTTAGAACAACT"	"RG"
"organoid3.GTAACGTCACAGGAGT"	"Cycling"
"organoid3.TCTCATATCAACGAAA"	"RG"
"organoid3.GGAATAAGTCGTCTTC"	"RG"
"organoid3.CTAATGGAGACACGAC"	"RG"
"organoid3.CTAGCCTGTACAGACG"	"RG"
"organoid3.TACGGATAGGCTCAGA"	"RG"
"organoid3.GCATGATGTGTGCGTC"	"RG"
"organoid3.GGACAAGAGAAGCCCA"	"RG"
"organoid3.GATCGATAGCCCAACC"	"RG"
"organoid3.CAAGATCCAAAGGCGT"	"RG"
"organoid3.GACAGAGCATATACCG"	"RG"
"organoid3.TGACGGCGTACCGGCT"	"RG"
"organoid3.GACCAATCACAGGAGT"	"Cycling"
"organoid3.TACTCATTCGTTTAGG"	"RG"
"organoid3.AGCGTCGGTTGTACAC"	"RG"
"organoid3.CACAGTAGTCAGGACA"	"Cycling"
"organoid3.CGTAGGCTCGTGGACC"	"Cycling"
"organoid3.GCATGATCACAAGACG"	"RG"
"organoid3.CGTAGGCTCAGTCAGT"	"Cycling"
"organoid3.TACTTGTGTGCTAGCC"	"Cycling"
"organoid3.AGCGTCGCATAGTAAG"	"RG"
"organoid3.CATATGGCAGTACACT"	"RG"
"organoid3.GTTCGGGTCATCGATG"	"RG"
"organoid3.CACCACTAGCCCTAAT"	"RG"
"organoid3.GAACGGATCATGCTCC"	"RG"
"organoid3.GTCGTAACAGACAAAT"	"Cycling"
"organoid3.ACACCGGAGGAGTAGA"	"RG"
"organoid3.TGCGGGTTCCCTTGCA"	"RG"
"organoid3.CGTAGCGTCACTTACT"	"RG"
"organoid3.CCTTACGTCATTATCC"	"Cycling"
"organoid3.CAGCGACGTCTAGGTT"	"RG"
"organoid3.ACACCAAGTGAGGGAG"	"Cycling"
"organoid3.GCCTCTATCAAACCGT"	"Cycling"
"organoid3.AACTCCCTCAACACGT"	"RG"
"organoid3.CCTTTCTAGGTAAACT"	"RG"
"organoid3.TACCTATGTTCTGGTA"	"RG"
"organoid3.GCGCCAACAATAAGCA"	"RG"
"organoid3.ACTATCTGTAAGGGAA"	"RG"
"organoid3.CAGCAGCCAAGGCTCC"	"RG"
"organoid3.TAGGCATAGCTGCGAA"	"RG"
"organoid16.TACGGGCAGGTGATAT"	"RG"
"organoid16.TATTACCCAAGGCTCC"	"Cycling"
"organoid16.AGTAGTCAGCATGGCA"	"Cycling"
"organoid16.TCAGCAAAGTGACATA"	"Cycling"
"organoid16.TCGGGACTCGAATCCA"	"Cycling"
"organoid16.GTAACGTTCTCGCTTG"	"Cycling"
"organoid16.CGACCTTGTGAACCTT"	"Cycling"
"organoid16.GACTAACCATTTGCTT"	"Cycling"
"organoid16.CACCAGGTCAGCTCGG"	"Cycling"
"organoid16.TAAGCGTCAAAGCGGT"	"Cycling"
"organoid16.GTGCTTCGTCTTGCGG"	"Cycling"
"organoid16.GGACAGATCTTTAGTC"	"Cycling"
"organoid16.ATTCTACAGGCAAAGA"	"Cycling"
"organoid16.AAGACCTAGTGTGGCA"	"RG"
"organoid16.CAGCGACCACTGAAGG"	"Cycling"
"organoid16.ACGTCAAAGCGGATCA"	"Cycling"
"organoid16.GACGCGTCACAGAGGT"	"Cycling"
"organoid16.TCACAAGAGCACCGTC"	"Cycling"
"organoid16.CACACAAAGCTGCAAG"	"Cycling"
"organoid16.CCACTACAGCGACGTA"	"Cycling"
"organoid16.GGGACCTCAGTAAGCG"	"Cycling"
"organoid16.ACCGTAAAGTGTGAAT"	"Cycling"
"organoid16.CCGGTAGCAGTACACT"	"Cycling"
"organoid16.AGCTCTCTCCGTAGTA"	"Cycling"
"organoid16.CACACTCTCCCACTTG"	"Cycling"
"organoid16.GAATGAACACTTACGA"	"Cycling"
"organoid16.GCGGGTTTCGTACGGC"	"Cycling"
"organoid16.ACGCCAGGTCTAGTGT"	"Cycling"
"organoid16.CTACATTCAGGAATGC"	"Cycling"
"organoid16.CAGCGACCAAATTGCC"	"Cycling"
"organoid16.TCACGAAAGACAGACC"	"Cycling"
"organoid16.ACTGAGTTCGAGAACG"	"Cycling"
"organoid16.TAGAGCTTCTGCAGTA"	"Cycling"
"organoid16.TCTGAGATCCGCTGTT"	"Cycling"
"organoid16.ACGATACCAAATCCGT"	"Cycling"
"organoid16.CGAGAAGAGGACGAAA"	"Cycling"
"organoid16.CTCTAATTCTGAAAGA"	"Cycling"
"organoid16.AAGGAGCAGCTACCTA"	"Cycling"
"organoid16.TTTATGCAGTGTTTGC"	"Cycling"
"organoid16.ATCTACTAGCTGCGAA"	"Cycling"
"organoid16.TAGAGCTCAGCTATTG"	"Cycling"
"organoid16.AAGACCTCACGTTGGC"	"Cycling"
"organoid16.CGGGTCACATTGGGCC"	"Cycling"
"organoid16.TGCACCTCACCGGAAA"	"Cycling"
"organoid16.GAGGTGACAAGGACTG"	"Cycling"
"organoid16.TTCTTAGCAAACAACA"	"Cycling"
"organoid16.CAGGTGCGTGCCTTGG"	"Cycling"
"organoid16.TTCTTAGTCTCGCATC"	"Cycling"
"organoid16.CGAACATTCGAGAACG"	"Cycling"
"organoid16.ACCAGTAGTGGTGTAG"	"Cycling"
"organoid16.AGACGTTTCAAGAAGT"	"Cycling"
"organoid16.AACGTTGAGTGGTAGC"	"Cycling"
"organoid16.CTCGTACGTCCGTGAC"	"Cycling"
"organoid16.ACGGGCTCATCCGTGG"	"Cycling"
"organoid16.CATTATCTCATAGCAC"	"RG"
"organoid16.TTCTACATCCCGACTT"	"Cycling"
"organoid16.TGCCAAATCAACGCTA"	"Cycling"
"organoid16.ACGCCAGCACTCGACG"	"RG"
"organoid16.CGAGCCAGTGCAACGA"	"Cycling"
"organoid16.CAGGTGCTCAACACCA"	"Cycling"
"organoid16.CCCAGTTAGTAAGTAC"	"Cycling"
"organoid16.CAACCTCGTGTTGAGG"	"Cycling"
"organoid16.CCATTCGTCGGAGCAA"	"Cycling"
"organoid16.ATAAGAGGTAAGGATT"	"Cycling"
"organoid16.TGTCCCATCATCTGCC"	"Cycling"
"organoid16.ATGGGAGAGACGCTTT"	"Cycling"
"organoid16.AAATGCCCAATAACGA"	"Cycling"
"organoid16.CTCAGAATCAACGGGA"	"RG"
"organoid16.TTTCCTCAGTAGGCCA"	"Cycling"
"organoid16.CACACTCCAGGATCGA"	"Cycling"
"organoid16.AGCGGTCTCCGCAGTG"	"RG"
"organoid16.TGTTCCGGTGTGTGCC"	"Cycling"
"organoid16.CATCGAATCGGCGGTT"	"Cycling"
"organoid16.CGGAGCTAGACTGGGT"	"Cycling"
"organoid16.GGATTACAGGTGATTA"	"Cycling"
"organoid16.ACACCCTCAAGGTTTC"	"Cycling"
"organoid16.TTAGGACCAGGTGGAT"	"Cycling"
"organoid16.CACCACTGTCTGCGGT"	"Cycling"
"organoid16.CACATAGGTGATGCCC"	"Cycling"
"organoid16.TACAGTGCATGCTGGC"	"Cycling"
"organoid16.CTAGAGTAGGAGTTTA"	"Cycling"
"organoid16.ATAACGCGTGTGTGCC"	"RG"
"organoid16.TAGGCATGTGGTACAG"	"Cycling"
"organoid16.AGCATACCACGAAAGC"	"Cycling"
"organoid16.AGCATACAGACAGACC"	"Cycling"
"organoid16.GTGTTAGGTATAGGTA"	"Cycling"
"organoid16.CGCCAAGTCTGGGCCA"	"Cycling"
"organoid16.CTCTACGTCCGCTGTT"	"Cycling"
"organoid16.TCGCGAGGTTACGGAG"	"Cycling"
"organoid16.CTAGTGACATATACCG"	"Cycling"
"organoid16.TTCTTAGTCTTTACAC"	"Cycling"
"organoid16.CAACTAGCAGTAGAGC"	"Cycling"
"organoid16.TACACGACACCTCGGA"	"Cycling"
"organoid16.GGACATTTCACTATTC"	"Cycling"
"organoid16.AAAGATGTCCCTGACT"	"Cycling"
"organoid16.CGATCGGCAAGCGAGT"	"RG"
"organoid16.CCGTTCAGTCAGAATA"	"Cycling"
"organoid16.AGAGCGAAGTCATGCT"	"RG"
"organoid16.GGCGACTTCTCGATGA"	"Cycling"
"organoid16.GGGCATCTCCGCATCT"	"Cycling"
"organoid16.CTCGAAATCAACACCA"	"Cycling"
"organoid16.ACGATACAGGCAGTCA"	"Cycling"
"organoid16.CACAGTATCCTCGCAT"	"Cycling"
"organoid16.ACAGCCGGTGATAAGT"	"Cycling"
"organoid16.AGAGTGGTCTCTAAGG"	"Cycling"
"organoid16.AACTCTTCAGCTTAAC"	"Cycling"
"organoid16.CTTAGGACAATTCCTT"	"Cycling"
"organoid16.CCTCAGTCACGTCAGC"	"Cycling"
"organoid16.AACTCCCGTATGAATG"	"Cycling"
"organoid16.ATCACGACACTTGGAT"	"Cycling"
"organoid16.TCTGGAATCCACTCCA"	"Cycling"
"organoid16.AGCCTAAAGATGGGTC"	"Cycling"
"organoid16.GCGCAACAGAGTACAT"	"Cycling"
"organoid16.CCCAATCAGAATGTGT"	"Cycling"
"organoid16.CTGCCTACAATCAGAA"	"RG"
"organoid16.CATTCGCAGGCTATCT"	"Cycling"
"organoid16.TCTTTCCCAGTGGAGT"	"Cycling"
"organoid16.CACATTTAGCCTATGT"	"Cycling"
"organoid16.TTGCGTCTCATCACCC"	"RG"
"organoid16.CAGCAGCAGCTAGTCT"	"Cycling"
"organoid16.ATCTGCCCACGCCAGT"	"Cycling"
"organoid16.GGGTTGCCAGTGACAG"	"Cycling"
"organoid16.CAGCTAATCGAGCCCA"	"RG"
"organoid16.TGAGCATGTCAGAATA"	"RG"
"organoid16.TCACAAGCAAAGTCAA"	"Cycling"
"organoid16.TGAAAGATCGGAATCT"	"Cycling"
"organoid16.CGTGTCTTCGGCGCAT"	"Cycling"
"organoid16.ATGTGTGCATCTGGTA"	"Cycling"
"organoid16.AAAGCAATCATGTAGC"	"RG"
"organoid16.AACCATGGTTAGATGA"	"RG"
"organoid16.TCTTCGGGTGGCGAAT"	"Cycling"
"organoid16.CGGACTGAGTCTCGGC"	"RG"
"organoid16.CAGCATAAGAGTACAT"	"Cycling"
"organoid16.AACTCAGAGGGCATGT"	"RG"
"organoid16.AGGTCCGAGTGCCAGA"	"Cycling"
"organoid16.CAGCGACTCTTCAACT"	"Cycling"
"organoid16.TGGCTGGTCTAACTTC"	"RG"
"organoid16.CAGGTGCCATACAGCT"	"Cycling"
"organoid16.AGGGATGAGGGCTCTC"	"Cycling"
"organoid16.GAAACTCGTCGCGTGT"	"RG"
"organoid16.GTGAAGGTCGAACGGA"	"RG"
"organoid16.GATGAGGGTCAACTGT"	"Cycling"
"organoid16.GGGTCTGGTCCCTTGT"	"Cycling"
"organoid16.ATCTGCCGTTACCGAT"	"Cycling"
"organoid16.CTCATTAGTACAAGTA"	"RG"
"organoid16.ATTGGTGCAATCCGAT"	"RG"
"organoid16.CTCTACGTCTGATACG"	"RG"
"organoid16.ACTATCTCAGCATGAG"	"Cycling"
"organoid16.ACTGTCCAGTGTGAAT"	"Cycling"
"organoid16.AATCGGTAGGATATAC"	"Cycling"
"organoid16.CGAGCCATCCACGCAG"	"RG"
"organoid16.TTCTCCTTCCCTCTTT"	"RG"
"organoid16.GTCTTCGGTACCAGTT"	"RG"
"organoid16.CATGCCTCAGGTCTCG"	"Cycling"
"organoid16.GATGAGGTCAACTCTT"	"Cycling"
"organoid16.GCAAACTTCCGCAAGC"	"Cycling"
"organoid16.ACAGCTAAGGACGAAA"	"Cycling"
"organoid16.AGTGGGATCCATGAGT"	"RG"
"organoid16.GTGGGTCTCATAAAGG"	"Cycling"
"organoid16.CAACTAGCACTGTCGG"	"Cycling"
"organoid16.ATTACTCTCGATAGAA"	"Cycling"
"organoid16.ACTTGTTTCTGTACGA"	"Cycling"
"organoid16.CTCGGGAAGAGACTTA"	"Cycling"
"organoid16.CGCTATCGTATAAACG"	"Cycling"
"organoid16.GCTTCCAAGACTGGGT"	"Cycling"
"organoid16.CGGACTGAGCGTAGTG"	"Cycling"
"organoid16.ACGAGCCTCCTATTCA"	"Cycling"
"organoid16.CCTAGCTTCCTTGGTC"	"Cycling"
"organoid16.ACGCCGAGTCCGCTGA"	"Cycling"
"organoid16.GTTCATTCACGGTAAG"	"Cycling"
"organoid16.GAACATCTCACATGCA"	"Cycling"
"organoid16.ATTTCTGCATTGTGCA"	"Cycling"
"organoid16.AACTCAGGTACCGTTA"	"Cycling"
"organoid16.CTGTGCTAGGTCATCT"	"RG"
"organoid16.TCGGGACCAGACACTT"	"Cycling"
"organoid16.GACCAATGTGTTAAGA"	"Cycling"
"organoid16.TGACTAGGTACCCAAT"	"RG"
"organoid16.ACTGAACGTAGGACAC"	"RG"
"organoid16.CCACTACCAAATTGCC"	"Cycling"
"organoid16.GGACAAGTCACAGTAC"	"Cycling"
"organoid16.TACCTATAGTGCGATG"	"Cycling"
"organoid16.TACAGTGCACATCCGG"	"Cycling"
"organoid16.GACCAATGTAGTACCT"	"Cycling"
"organoid16.CTGAAACCAAGGTTCT"	"Cycling"
"organoid16.CGAACATGTCCCTACT"	"Cycling"
"organoid16.TTCTCCTAGGTAGCCA"	"Cycling"
"organoid16.CCTTCCCGTAGGCTGA"	"Cycling"
"organoid16.GTAGTCAGTGATGATA"	"Cycling"
"organoid16.CCATGTCCAACACCTA"	"RG"
"organoid16.TGGCCAGAGTCCAGGA"	"RG"
"organoid16.TCTATTGCACTTAACG"	"Cycling"
"organoid16.CGTTCTGTCACCACCT"	"Cycling"
"organoid16.ACTGAGTGTGTTGAGG"	"Cycling"
"organoid16.GCCAAATTCTTATCTG"	"RG"
"organoid16.TGGGAAGGTTGATTCG"	"RG"
"organoid16.GTAGGCCCATCGGACC"	"Cycling"
"organoid16.CTCGGAGTCCACTGGG"	"Cycling"
"organoid16.AAACGGGTCACCACCT"	"Cycling"
"organoid16.GTGTTAGGTTGCGTTA"	"Cycling"
"organoid16.CAGCCGACACAGACTT"	"RG"
"organoid16.CTGATCCAGTTAGGTA"	"Cycling"
"organoid16.CAACCTCCAGGTCTCG"	"RG"
"organoid16.ACATGGTAGGGCTCTC"	"RG"
"organoid16.CAGCCGAGTAGGACAC"	"Cycling"
"organoid16.CCTTTCTCACAAGTAA"	"Cycling"
"organoid16.TAGACCAGTCCATGAT"	"Cycling"
"organoid16.AATCCAGGTATATGGA"	"Cycling"
"organoid16.ACACCGGCAATAGCAA"	"Cycling"
"organoid16.GCACTCTTCAGCGATT"	"Cycling"
"organoid16.TGAAAGAGTTCGTCTC"	"Cycling"
"organoid16.CAGCAGCCAGTCCTTC"	"Cycling"
"organoid16.ACGAGGAGTACCGAGA"	"RG"
"organoid16.GCAAACTCACGGCTAC"	"RG"
"organoid16.AATCGGTCAGCTGCTG"	"RG"
"organoid16.GACCTGGTCTGGTATG"	"Cycling"
"organoid16.CTCACACGTTACGCGC"	"Cycling"
"organoid16.ATGGGAGTCCTTCAAT"	"RG"
"organoid16.GGGTTGCGTACCGTTA"	"Cycling"
"organoid16.GTAACGTCACGCCAGT"	"Cycling"
"organoid16.TCTCTAATCGCACTCT"	"Cycling"
"organoid16.GTCCTCATCTCATTCA"	"Cycling"
"organoid16.CTAGTGATCTTTACGT"	"RG"
"organoid16.GGGATGAGTTCCATGA"	"Cycling"
"organoid16.TTATGCTTCGGCGCTA"	"Cycling"
"organoid16.GATCTAGAGTGCCATT"	"Cycling"
"organoid16.CTCTACGTCGAATGGG"	"Cycling"
"organoid16.ATAAGAGAGTCGATAA"	"Cycling"
"organoid16.GATGAGGTCGTTTGCC"	"RG"
"organoid16.CCGGTAGTCGTCCGTT"	"Cycling"
"organoid16.ACGAGCCGTGCCTGTG"	"Cycling"
"organoid16.CTTAACTTCACCGGGT"	"Cycling"
"organoid16.TTGACTTCAGACGTAG"	"RG"
"organoid16.TCAGCAACAGCTGTAT"	"Cycling"
"organoid16.GTTTCTACAATCTACG"	"Cycling"
"organoid16.GACAGAGTCTTTAGGG"	"Cycling"
"organoid16.CAACCAAGTCCTCCAT"	"Cycling"
"organoid16.TACTTGTGTCTACCTC"	"Cycling"
"organoid16.CGGACGTCACGGTAGA"	"Cycling"
"organoid16.AGAATAGTCGCGCCAA"	"Cycling"
"organoid16.CAAGTTGTCAGTGCAT"	"Cycling"
"organoid16.CACCAGGCATTCCTCG"	"Cycling"
"organoid16.TGAGCATAGTGTACTC"	"Cycling"
"organoid16.ATCGAGTCACAGGCCT"	"Cycling"
"organoid16.CAGCAGCAGGGCTCTC"	"Cycling"
"organoid16.CTGAAACAGGATATAC"	"Cycling"
"organoid16.GAACATCCAGCTCGAC"	"Cycling"
"organoid16.TACTTACTCTGGTATG"	"RG"
"organoid16.TGCACCTTCGCTGATA"	"Cycling"
"organoid16.GATGAGGCACCAGATT"	"Cycling"
"organoid16.GTAACGTTCTTCTGGC"	"Cycling"
"organoid16.CAGTCCTGTCTAAACC"	"Cycling"
"organoid16.TTGGAACAGCGCCTCA"	"RG"
"organoid16.CTTAACTAGTTTCCTT"	"Cycling"
"organoid16.GATCGATCACAGGAGT"	"RG"
"organoid16.CTTACCGGTCATATCG"	"Cycling"
"organoid16.GTGCATAGTGGCAAAC"	"Cycling"
"organoid16.CGAGAAGTCACATGCA"	"Cycling"
"organoid16.CATCCACTCTGCGTAA"	"Cycling"
"organoid16.CTGAAGTTCGTGACAT"	"Cycling"
"organoid16.GGGACCTAGGCTACGA"	"Cycling"
"organoid16.TCAGCAATCGTCCGTT"	"RG"
"organoid16.ACTATCTTCCCTGACT"	"Cycling"
"organoid16.ATTATCCGTTGCTCCT"	"Cycling"
"organoid16.TCATTTGTCCTTCAAT"	"Cycling"
"organoid16.CGATGTAAGACCGGAT"	"Cycling"
"organoid16.TTAGGCAAGGATGCGT"	"Cycling"
"organoid16.CAGCCGAGTGAACCTT"	"RG"
"organoid16.ACGGAGAAGGACGAAA"	"Cycling"
"organoid16.TCGTAGACATCCAACA"	"Cycling"
"organoid16.CAGCATATCAGCTTAG"	"Cycling"
"organoid16.TGCCCATAGCAGCGTA"	"RG"
"organoid16.GCACTCTCATCGGTTA"	"Cycling"
"organoid16.TACAGTGTCATCTGCC"	"Cycling"
"organoid16.TCGAGGCCAGATCGGA"	"Cycling"
"organoid16.CATGCCTTCGTAGATC"	"Cycling"
"organoid16.AAGGCAGAGTCCATAC"	"Cycling"
"organoid16.GCGAGAAAGTAGATGT"	"RG"
"organoid16.TTAACTCCAAACTGCT"	"Cycling"
"organoid16.GAGTCCGTCGGTCTAA"	"RG"
"organoid16.GTCGGGTTCAACACGT"	"Cycling"
"organoid16.TTAACTCTCGCCATAA"	"Cycling"
"organoid16.CTAACTTTCGTTACGA"	"Cycling"
"organoid16.GCAGTTAGTAGTGAAT"	"Cycling"
"organoid16.CGAACATTCTCGGACG"	"RG"
"organoid16.GCACATACAAACCTAC"	"Cycling"
"organoid16.CAACTAGGTTTAAGCC"	"RG"
"organoid16.GCAAACTGTACCGTTA"	"Cycling"
"organoid16.GTGTTAGCATAAAGGT"	"Cycling"
"organoid16.CTAATGGAGTGAAGAG"	"Cycling"
"organoid16.GGGATGACAGACAAAT"	"RG"
"organoid16.ACATACGCACGCGAAA"	"Cycling"
"organoid16.CGTGTCTAGATGGCGT"	"Cycling"
"organoid16.GGGAGATGTGTTGGGA"	"RG"
"organoid16.CATTATCCATCACCCT"	"Cycling"
"organoid16.TACACGAGTAGGACAC"	"Cycling"
"organoid16.ACGTCAAGTCGTCTTC"	"RG"
"organoid16.ACACCGGGTTTACTCT"	"Cycling"
"organoid16.ATTATCCCAATCCAAC"	"Cycling"
"organoid16.TGAGCCGAGACGACGT"	"Cycling"
"organoid16.CGATGGCAGCAGACTG"	"RG"
"organoid16.ACTGTCCGTACAGCAG"	"Cycling"
"organoid16.GAATGAAAGTGCCATT"	"Cycling"
"organoid16.TTCGGTCTCATGCATG"	"Cycling"
"organoid16.TGCGGGTGTACCCAAT"	"Cycling"
"organoid16.CCGTGGAAGTTTAGGA"	"Cycling"
"organoid16.CACCAGGCAAGCGCTC"	"Cycling"
"organoid16.TAGAGCTCATAAAGGT"	"Cycling"
"organoid16.AAAGATGTCTGATACG"	"RG"
"organoid16.GATCGTATCCGGGTGT"	"Cycling"
"organoid16.CGAACATCAGACAAAT"	"Cycling"
"organoid16.TAAGAGACAGGGCATA"	"RG"
"organoid16.GACGGCTAGCGCTTAT"	"RG"
"organoid16.ACGAGGACATCTCCCA"	"Cycling"
"organoid16.CTGGTCTAGACAGAGA"	"Cycling"
"organoid16.AAGACCTGTAAATGAC"	"RG"
"organoid16.TTGGAACCAAACGCGA"	"Cycling"
"organoid16.TGACTTTAGAAAGTGG"	"Cycling"
"organoid16.CCTTACGGTTCAGGCC"	"Cycling"
"organoid16.CGGACTGCACCAGCAC"	"RG"
"organoid16.TCTCTAACATGTTCCC"	"Cycling"
"organoid16.CTCGGAGCACAGAGGT"	"Cycling"
"organoid16.CAGGTGCAGAAGGACA"	"Cycling"
"organoid16.ATAACGCGTTGATTCG"	"RG"
"organoid16.GCTGCGAAGTTGTCGT"	"RG"
"organoid16.TGAGAGGAGGCCCGTT"	"Cycling"
"organoid16.CCATTCGAGAAACGCC"	"Cycling"
"organoid16.GCAATCATCCAAAGTC"	"Cycling"
"organoid16.ACTGATGAGCTAGTCT"	"Cycling"
"organoid16.ACTATCTCAAACTGCT"	"Cycling"
"organoid16.TTTGTCAAGAAGAAGC"	"Cycling"
"organoid16.ACACCCTAGAAGAAGC"	"RG"
"organoid16.CGGACTGCAGTTTACG"	"Cycling"
"organoid16.ACGCCAGAGCCGTCGT"	"RG"
"organoid16.TCAGCTCCAATGCCAT"	"Cycling"
"organoid16.GGGAATGCACCAGATT"	"Cycling"
"organoid16.TATCAGGCATGTAGTC"	"RG"
"organoid16.CCAGCGACAACGATGG"	"Cycling"
"organoid16.CCTACCAGTCTTTCAT"	"Cycling"
"organoid16.GTTAAGCGTTTCCACC"	"Cycling"
"organoid16.CTTTGCGTCCAAACTG"	"RG"
"organoid16.ACTGTCCCACAGCCCA"	"Cycling"
"organoid16.CCGGGATCACAAGTAA"	"RG"
"organoid16.GCACTCTGTCAGAAGC"	"Cycling"
"organoid16.CATCCACAGCTGCCCA"	"Cycling"
"organoid16.CTACATTGTGTCGCTG"	"Cycling"
"organoid16.TCTGGAACACATGGGA"	"Cycling"
"organoid16.CCACCTAAGCGAGAAA"	"Cycling"
"organoid16.AACCATGAGTAGTGCG"	"Cycling"
"organoid16.ACTGAGTGTTCCACAA"	"Cycling"
"organoid16.CTTCTCTCAACACGCC"	"Cycling"
"organoid16.AGTTGGTAGGAATGGA"	"Cycling"
"organoid16.AAGGCAGCACTCTGTC"	"Cycling"
"organoid16.TACACGATCTGCCCTA"	"Cycling"
"organoid16.CTCGTACAGGTGATTA"	"Cycling"
"organoid16.TGACGGCAGGGCTCTC"	"Cycling"
"organoid16.GACGTGCAGGGCTTCC"	"Cycling"
"organoid16.GGGTCTGTCCGAAGAG"	"RG"
"organoid16.ATTGGACAGAGCTATA"	"RG"
"organoid16.TTCTCAATCAACCATG"	"Cycling"
"organoid16.CGAGCCACACGTCTCT"	"RG"
"organoid16.GCAAACTTCACGCGGT"	"Cycling"
"organoid16.GTTTCTATCAGTGTTG"	"Cycling"
"organoid16.GAGTCCGAGATGTTAG"	"Cycling"
"organoid16.AAACGGGCACATAACC"	"RG"
"organoid16.GCCAAATAGGCAGTCA"	"Cycling"
"organoid16.ATGAGGGAGCACCGCT"	"Cycling"
"organoid16.CACACAAGTGTAAGTA"	"Cycling"
"organoid16.ACCCACTCAACAACCT"	"Cycling"
"organoid16.AAGGTTCAGCAGGCTA"	"Cycling"
"organoid16.CAGGTGCCAACACGCC"	"RG"
"organoid16.TGAGAGGTCACGACTA"	"Cycling"
"organoid16.GCTGCAGCATTGGCGC"	"Cycling"
"organoid16.CGATGGCCAATGTTGC"	"Cycling"
"organoid16.CAGAATCTCGTGGACC"	"RG"
"organoid16.CCTCTGAGTTTAGCTG"	"RG"
"organoid16.CTGCTGTTCCGTAGTA"	"Cycling"
"organoid16.TGGGAAGTCTGGCGTG"	"Cycling"
"organoid16.GGACATTGTTTGTTTC"	"Cycling"
"organoid16.CTCGGAGAGGAGCGTT"	"Cycling"
"organoid16.GCGGGTTCATCACAAC"	"Cycling"
"organoid16.GTGTTAGTCACTCTTA"	"Cycling"
"organoid16.GTCAAGTGTCGCATCG"	"Cycling"
"organoid16.GTATTCTGTGAGTGAC"	"Cycling"
"organoid16.CTTTGCGGTGACTCAT"	"Cycling"
"organoid16.GGAATAAAGCTATGCT"	"Cycling"
"organoid16.CCATGTCTCGGACAAG"	"Cycling"
"organoid16.CTGAAACAGAGCAATT"	"Cycling"
"organoid16.ACGCCGATCTCGATGA"	"Cycling"
"organoid16.GGTGAAGTCCCGGATG"	"Cycling"
"organoid16.TTGTAGGAGTCCTCCT"	"Cycling"
"organoid16.AGAGCTTGTCTTGTCC"	"RG"
"organoid16.AAGCCGCAGATCCTGT"	"Cycling"
"organoid16.ACGGAGAAGTGGTCCC"	"Cycling"
"organoid16.TCTCTAAGTATAGTAG"	"Cycling"
"organoid16.GTACTTTGTCCGTGAC"	"Cycling"
"organoid16.AGATTGCAGACTAGAT"	"Cycling"
"organoid16.CCGTGGAAGCCGGTAA"	"Cycling"
"organoid16.GGAAAGCGTCAAACTC"	"Cycling"
"organoid16.ACTTGTTGTGTTGGGA"	"Cycling"
"organoid16.AACTGGTGTACAAGTA"	"Cycling"
"organoid16.GCGCCAAAGTCCATAC"	"RG"
"organoid16.CTTAGGAGTAAGAGGA"	"Cycling"
"organoid16.GCGACCATCAGAGACG"	"Cycling"
"organoid16.GTCGGGTTCAACTCTT"	"Cycling"
"organoid16.TTGGAACTCTTTAGTC"	"Cycling"
"organoid16.GCCAAATGTGTTCGAT"	"Cycling"
"organoid16.CCCAGTTGTCGAAAGC"	"Cycling"
"organoid16.CATCAGAAGTATTGGA"	"RG"
"organoid16.AACTGGTAGCATGGCA"	"Cycling"
"organoid16.CAAGATCTCTATCGCC"	"Cycling"
"organoid16.GAACATCGTTGATTGC"	"Cycling"
"organoid16.AGAATAGCAGACACTT"	"Cycling"
"organoid16.TGAGAGGAGGCACATG"	"Cycling"
"organoid16.TAGTGGTCAACACCTA"	"Cycling"
"organoid16.CAGAATCTCGCCCTTA"	"Cycling"
"organoid16.AGGCCACTCTCCTATA"	"RG"
"organoid16.CCGTTCAAGGTAGCCA"	"Cycling"
"organoid16.TAAACCGCACGAGAGT"	"Cycling"
"organoid16.CCTAGCTCACCATCCT"	"Cycling"
"organoid16.CGGACTGGTAGCTAAA"	"Cycling"
"organoid16.GTTACAGCACCCTATC"	"Cycling"
"organoid16.CTGCGGAGTATAGGGC"	"Cycling"
"organoid16.TTTCCTCGTCTCCACT"	"Cycling"
"organoid16.CCACGGAGTAGGCTGA"	"Cycling"
"organoid16.CGGACTGGTTACCAGT"	"Cycling"
"organoid16.CATTCGCCAAGAAAGG"	"Cycling"
"organoid16.CTCACACCAAATTGCC"	"Cycling"
"organoid16.TTTCCTCCACAGGTTT"	"Cycling"
"organoid16.TAGAGCTGTAGTACCT"	"Cycling"
"organoid16.CTTAACTGTCATCGGC"	"Cycling"
"organoid16.CATATTCAGATGTTAG"	"Cycling"
"organoid16.CACATTTTCAACCATG"	"Cycling"
"organoid16.GTTCATTAGTTCGCAT"	"RG"
"organoid16.GTCGGGTCAGGTCTCG"	"Cycling"
"organoid16.TACACGATCTTATCTG"	"Cycling"
"organoid16.CTAGCCTAGTACGCGA"	"RG"
"organoid16.GGACAGATCGTATCAG"	"Cycling"
"organoid16.TCAGGATTCACGCGGT"	"Cycling"
"organoid16.CGTCAGGAGGCTCTTA"	"Cycling"
"organoid16.GGTGCGTGTAGGACAC"	"Cycling"
"organoid16.CGCTATCTCAAGGTAA"	"Cycling"
"organoid16.AAAGTAGTCGCCGTGA"	"Cycling"
"organoid16.AAGGCAGGTCTGCCAG"	"RG"
"organoid16.CCCAATCTCGGCTTGG"	"Cycling"
"organoid16.TACGGGCAGCTGAACG"	"Cycling"
"organoid16.TAGTGGTCAGATGAGC"	"RG"
"organoid16.GGGAGATGTGTAATGA"	"Cycling"
"organoid16.CTGGTCTTCGAACTGT"	"Cycling"
"organoid16.TCGGTAATCTCGCATC"	"RG"
"organoid16.TTCGAAGCAGATCTGT"	"Cycling"
"organoid16.AACCGCGGTCCTCTTG"	"Cycling"
"organoid16.CAGCTGGAGCTGAACG"	"Cycling"
"organoid16.TAGAGCTGTTATTCTC"	"Cycling"
"organoid16.GCGACCAGTTATTCTC"	"Cycling"
"organoid16.AAAGCAATCTTAGAGC"	"Cycling"
"organoid16.TCTCTAAAGATCGGGT"	"Cycling"
"organoid16.ATGGGAGCAACTGCTA"	"RG"
"organoid16.TAGACCAGTGCGGTAA"	"Cycling"
"organoid16.TGCTACCGTAAGAGAG"	"RG"
"organoid16.AGCATACTCTGAAAGA"	"Cycling"
"organoid16.ATCTGCCAGGTTCCTA"	"Cycling"
"organoid16.ACTTGTTAGGAGCGTT"	"RG"
"organoid16.AAACCTGAGAGTACAT"	"RG"
"organoid16.GTCACAACACCTCGGA"	"Cycling"
"organoid16.CGCCAAGTCCTGCCAT"	"RG"
"organoid16.CGATTGAGTCATGCAT"	"Cycling"
"organoid16.CCCTCCTAGAGCTTCT"	"Cycling"
"organoid16.ACTGAGTAGCCCAACC"	"Cycling"
"organoid16.TTGCGTCAGGTGATAT"	"Cycling"
"organoid16.AGAGTGGTCTGTGCAA"	"Cycling"
"organoid16.CTTACCGTCAGCTCTC"	"RG"
"organoid16.GGGATGACAGGACGTA"	"Cycling"
"organoid16.AGGGTGAAGCAACGGT"	"Cycling"
"organoid16.GACGCGTAGTGCGATG"	"Cycling"
"organoid16.TCGGTAACAAACTGTC"	"Cycling"
"organoid16.AGGGTGACACATGGGA"	"Cycling"
"organoid16.ATAGACCGTCTCGTTC"	"Cycling"
"organoid16.TCGAGGCAGGCGCTCT"	"RG"
"organoid16.GCACATAAGCCAGTAG"	"Cycling"
"organoid16.CAGAATCCAGGTCCAC"	"Cycling"
"organoid16.GCGACCACAGATGGCA"	"Cycling"
"organoid16.GATTCAGCACGACTCG"	"RG"
"organoid16.TCAGCAAAGCTTATCG"	"Cycling"
"organoid16.ACACCCTAGTATCTCG"	"Cycling"
"organoid16.GATGAAAAGCGTTGCC"	"Cycling"
"organoid16.GAATGAAAGATGTTAG"	"RG"
"organoid16.CGGCTAGTCAACACTG"	"Cycling"
"organoid16.GAATAAGCATCGGACC"	"Cycling"
"organoid16.ATCATGGCAGTTCATG"	"Cycling"
"organoid16.CTACCCACAGCGTTCG"	"Cycling"
"organoid16.CAAGGCCTCCTCAATT"	"Cycling"
"organoid16.ACAGCTAAGCTAAGAT"	"Cycling"
"organoid16.CTGCCTACACGAAACG"	"RG"
"organoid16.CGTCAGGAGTCTTGCA"	"Cycling"
"organoid16.ACAGCCGCAGTAAGCG"	"Cycling"
"organoid16.CAGCCGATCGCCATAA"	"Cycling"
"organoid16.CAGTCCTGTTGTTTGG"	"Cycling"
"organoid16.ACGATACAGATTACCC"	"Cycling"
"organoid16.CGTCAGGAGCTGGAAC"	"RG"
"organoid16.ACTTACTGTACCATCA"	"Cycling"
"organoid16.TCGTACCCACAGGTTT"	"Cycling"
"organoid16.TGTGGTAAGTACCGGA"	"Cycling"
"organoid16.CGACTTCTCGGATGGA"	"RG"
"organoid16.GATGAAAAGAAGAAGC"	"Cycling"
"organoid16.ACGAGGAAGCGTCTAT"	"Cycling"
"organoid16.GGGTCTGAGAAGCCCA"	"Cycling"
"organoid16.GTACTCCCATCTCGCT"	"Cycling"
"organoid16.GGGCACTCATCGGAAG"	"RG"
"organoid16.GGAATAAGTCAATGTC"	"RG"
"organoid16.GCACTCTGTATCGCAT"	"Cycling"
"organoid16.GAAGCAGCATCGATGT"	"RG"
"organoid16.GGTGTTACAAGCTGTT"	"RG"
"organoid16.GGACATTCATGAGCGA"	"Cycling"
"organoid16.TGGTTCCTCTAGCACA"	"Cycling"
"organoid16.AGTGAGGAGCCTATGT"	"Cycling"
"organoid16.AAAGCAAGTAGCACGA"	"Cycling"
"organoid16.GGCCGATAGCCGCCTA"	"RG"
"organoid16.GGTGCGTCAATGCCAT"	"Cycling"
"organoid16.GTATCTTAGGTGATTA"	"Cycling"
"organoid16.GCTTGAATCTCTTATG"	"Cycling"
"organoid16.TTTGGTTAGCCCAACC"	"Cycling"
"organoid16.ATCCGAACATGCATGT"	"RG"
"organoid16.GCATGCGCATGCAACT"	"Cycling"
"organoid16.GATCGATGTGGACGAT"	"RG"
"organoid16.TGATTTCGTTATCACG"	"Cycling"
"organoid16.AGCGTATAGTTCGATC"	"Cycling"
"organoid16.CCTAGCTAGGGTTTCT"	"Cycling"
"organoid16.GTAACGTAGGAGTACC"	"RG"
"organoid16.TTCTCCTAGACTAAGT"	"Cycling"
"organoid16.GCGCAACCACATCCGG"	"Cycling"
"organoid16.TTCTCAAAGGACAGCT"	"Cycling"
"organoid16.ATCTACTAGCTTATCG"	"Cycling"
"organoid16.GGCTCGACACTAGTAC"	"Cycling"
"organoid16.CTACCCATCTTGAGGT"	"Cycling"
"organoid16.GATGCTACACCAACCG"	"Cycling"
"organoid16.GCTGCTTAGGCCCGTT"	"Cycling"
"organoid16.AACCATGCATGGGACA"	"Cycling"
"organoid16.CAGAATCGTACCAGTT"	"Cycling"
"organoid16.TGAGCATTCCTTGCCA"	"Cycling"
"organoid16.CGTTGGGGTCAATGTC"	"Cycling"
"organoid16.AGCGTATCAGTCCTTC"	"Cycling"
"organoid16.CACATAGCATTGTGCA"	"Cycling"
"organoid16.AGGTCCGTCCGTAGGC"	"Cycling"
"organoid16.TTAGTTCCAGCTGGCT"	"Cycling"
"organoid16.ACTGAACAGCTAGTTC"	"Cycling"
"organoid16.CGATGTAGTAGCTCCG"	"Cycling"
"organoid16.TCTCTAAGTTTGACTG"	"RG"
"organoid16.CGGACTGGTAGCTCCG"	"Cycling"
"organoid16.AATCCAGGTACTTGAC"	"Cycling"
"organoid16.GCATACATCCTACAGA"	"Cycling"
"organoid16.TAGTGGTAGGCCGAAT"	"Cycling"
"organoid16.ACTGCTCCAGGACCCT"	"Cycling"
"organoid16.AGCTCTCTCGGTGTCG"	"Cycling"
"organoid16.CCTTCCCGTTCGGCAC"	"Cycling"
"organoid16.GGGTCTGTCCATGAAC"	"Cycling"
"organoid16.AGACGTTAGCCATCGC"	"Cycling"
"organoid16.CGGGTCACATAACCTG"	"Cycling"
"organoid16.TGAGGGAAGTCCAGGA"	"RG"
"organoid16.GCTTGAAAGGTGCTTT"	"Cycling"
"organoid16.TATCAGGCAAACGCGA"	"Cycling"
"organoid16.ACGGAGATCTATCCCG"	"Cycling"
"organoid16.CGTCACTTCGTAGGTT"	"Cycling"
"organoid16.TGAGGGAAGCTGCAAG"	"Cycling"
"organoid16.AGCTTGAGTTGACGTT"	"Cycling"
"organoid16.ACACCAAGTATATCCG"	"RG"
"organoid16.CACATAGGTGGCAAAC"	"Cycling"
"organoid16.GTCAAGTGTCCAGTTA"	"Cycling"
"organoid16.GATTCAGCATAGACTC"	"Cycling"
"organoid16.TCTGGAAGTGCTGTAT"	"Cycling"
"organoid16.GATCAGTCAATAGCAA"	"Cycling"
"organoid16.ATAGACCAGGCTCAGA"	"Cycling"
"organoid16.AGCGGTCTCACTGGGC"	"Cycling"
"organoid16.CTCGGGATCCTTTCTC"	"Cycling"
"organoid16.CTAGAGTAGCGGATCA"	"Cycling"
"organoid16.CGCGTTTGTCTCATCC"	"Cycling"
"organoid16.CCGGGATGTCGGATCC"	"Cycling"
"organoid16.CCCATACTCAAGCCTA"	"Cycling"
"organoid16.GCTGGGTCAATAGCGG"	"Cycling"
"organoid16.TTGAACGGTGAAAGAG"	"Cycling"
"organoid16.CATCGAACAGCTGTTA"	"RG"
"organoid16.CGACCTTCAGACGCAA"	"Cycling"
"organoid16.GACGTTAGTTGAGGTG"	"Cycling"
"organoid16.CTGTTTAGTTACCGAT"	"RG"
"organoid16.GGCAATTCAAGCTGGA"	"Cycling"
"organoid16.TTGCGTCCAGTATAAG"	"Cycling"
"organoid16.CGAGCCACAAGTAGTA"	"Cycling"
"organoid16.CCAGCGAAGGTAGCCA"	"Cycling"
"organoid16.CGGAGCTGTGACTACT"	"Cycling"
"organoid16.CCTATTATCAACGGCC"	"Cycling"
"organoid16.CATATTCAGCTCTCGG"	"RG"
"organoid16.TGGCGCAGTCTTCAAG"	"Cycling"
"organoid16.TCTGAGACACGTCTCT"	"RG"
"organoid16.CTAACTTCAGCCTTTC"	"Cycling"
"organoid16.CAGTCCTGTCAGATAA"	"Cycling"
"organoid16.CTGTGCTAGCGTAATA"	"Cycling"
"organoid16.GCATGTAGTGAACCTT"	"Cycling"
"organoid16.GACACGCGTGTGAAAT"	"Cycling"
"organoid16.GAACCTACATCTCGCT"	"Cycling"
"organoid16.TGAAAGAAGTGTCTCA"	"Cycling"
"organoid16.CCGGTAGTCAGTTGAC"	"Cycling"
"organoid16.CTCGTCAAGGACGAAA"	"Cycling"
"organoid16.ACACCGGTCTACCAGA"	"Cycling"
"organoid16.AGCTCCTAGGCTACGA"	"Cycling"
"organoid16.GGGCACTAGTGGTCCC"	"Cycling"
"organoid16.CTCGTCAGTACAGTGG"	"Cycling"
"organoid16.TGGGAAGGTACGACCC"	"Cycling"
"organoid16.AACTCCCGTATCTGCA"	"Cycling"
"organoid16.CGACTTCTCAGGATCT"	"Cycling"
"organoid16.ATCATCTAGGCACATG"	"Cycling"
"organoid16.GTATTCTCAGTCTTCC"	"Cycling"
"organoid16.TCGCGTTAGATATGGT"	"Cycling"
"organoid16.TAGACCACACTGTTAG"	"RG"
"organoid16.CGCGTTTGTCAATACC"	"Cycling"
"organoid16.TAGGCATGTGTCGCTG"	"Cycling"
"organoid16.CTCGGGATCCCAACGG"	"Cycling"
"organoid16.CAAGAAAGTGGTTTCA"	"Cycling"
"organoid16.GACCTGGGTCTAACGT"	"Cycling"
"organoid16.ATCGAGTGTGTTTGTG"	"Cycling"
"organoid16.GTGTGCGTCACATACG"	"RG"
"organoid16.GCATGCGTCGCCATAA"	"Cycling"
"organoid16.TCAGCAATCAAACCGT"	"Cycling"
"organoid16.GCTGCTTCACTAAGTC"	"Cycling"
"organoid16.CCAATCCCATTGGGCC"	"Cycling"
"organoid16.GTACTCCCATCCGTGG"	"Cycling"
"organoid16.CGACCTTGTACGCTGC"	"Cycling"
"organoid16.CGCTTCAGTCGCGGTT"	"RG"
"organoid16.GTCAAGTGTCTAAACC"	"Cycling"
"organoid16.TCGCGAGAGCCCGAAA"	"Cycling"
"organoid16.GCAATCACAATCACAC"	"Cycling"
"organoid16.CATCGGGTCCCACTTG"	"Cycling"
"organoid16.CAAGATCAGGCACATG"	"Cycling"
"organoid16.TGGTTCCCATGCCTAA"	"Cycling"
"organoid16.CAACCTCTCAAACAAG"	"Cycling"
"organoid16.ACACCAAGTATAGGTA"	"Cycling"
"organoid16.CGTTCTGCATCCTAGA"	"Cycling"
"organoid16.TTCTACAGTCGCCATG"	"Cycling"
"organoid16.AACTTTCGTCTGCGGT"	"Cycling"
"organoid16.CGATGGCCAATCAGAA"	"Cycling"
"organoid16.GGGAATGGTCTGCCAG"	"Cycling"
"organoid16.CTAAGACCAGCGTCCA"	"Cycling"
"organoid16.AGAGCTTAGGATGGAA"	"Cycling"
"organoid16.TGGTTCCAGTCCATAC"	"Cycling"
"organoid16.GCTGCAGAGGCATTGG"	"Cycling"
"organoid16.GACGGCTCAGCGATCC"	"Cycling"
"organoid16.CGTTGGGGTAGCAAAT"	"RG"
"organoid16.CGTTAGAGTTACCAGT"	"RG"
"organoid16.GCATGCGGTCTTGATG"	"Cycling"
"organoid16.AGATTGCCATTTGCTT"	"Cycling"
"organoid16.ACACTGAAGAGGTTGC"	"Cycling"
"organoid16.AGAATAGTCTGCCCTA"	"RG"
"organoid16.TGAGCATCACTACAGT"	"Cycling"
"organoid16.AGAATAGGTAGCACGA"	"Cycling"
"organoid16.GATCGTATCCAAACAC"	"RG"
"organoid16.TCGCGTTGTGTGCCTG"	"Cycling"
"organoid16.GGAACTTCATTAGGCT"	"Cycling"
"organoid16.GTGTGCGGTTGTGGAG"	"Cycling"
"organoid16.ACATGGTTCTTCATGT"	"Cycling"
"organoid16.CCTTTCTCAAGTACCT"	"Cycling"
"organoid16.TTTGTCAAGAATGTGT"	"Cycling"
"organoid16.CTCGAGGGTGCCTGCA"	"Cycling"
"organoid16.CTCGAGGAGAAAGTGG"	"RG"
"organoid16.GTTCTCGTCACTGGGC"	"Cycling"
"organoid16.GTGCAGCAGAACAATC"	"RG"
"organoid16.TACCTTATCCAATGGT"	"RG"
"organoid16.TCTTTCCAGATCCGAG"	"RG"
"organoid16.ATTGGACTCCAGTAGT"	"Cycling"
"organoid16.CAGCCGATCGTCCGTT"	"RG"
"organoid16.GGGCACTTCAGGATCT"	"Cycling"
"organoid16.AAGGTTCCACGGACAA"	"Cycling"
"organoid16.CTCAGAACACCAGGTC"	"RG"
"organoid16.ATCATGGTCGATGAGG"	"Cycling"
"organoid16.TCTGGAAAGGGATACC"	"Cycling"
"organoid16.GATCGCGCAGGTTTCA"	"Cycling"
"organoid16.TTCTCAAAGATAGTCA"	"RG"
"organoid16.TGCTACCAGGAGTAGA"	"Cycling"
"organoid16.TGTGGTACACAGGCCT"	"Cycling"
"organoid16.GTTTCTAGTCACACGC"	"Cycling"
"organoid16.GACGCGTCACGTGAGA"	"Cycling"
"organoid16.GACAGAGGTCAACATC"	"Cycling"
"organoid16.GCGAGAATCAGCGACC"	"Cycling"
"organoid16.GGGAGATCATCCAACA"	"Cycling"
"organoid16.ATTATCCAGCTGTCTA"	"RG"
"organoid16.TATCAGGTCGTAGATC"	"RG"
"organoid16.CCGGTAGCACGACTCG"	"Cycling"
"organoid16.CCGTACTAGGGCTTGA"	"Cycling"
"organoid16.GGATTACAGGTGACCA"	"Cycling"
"organoid16.GTCATTTCACTGAAGG"	"Cycling"
"organoid16.CGGACTGAGAGCTGGT"	"Cycling"
"organoid16.GGGAATGGTAAATGTG"	"Cycling"
"organoid16.GCATGCGGTATCACCA"	"Cycling"
"organoid16.GTCTTCGTCTCCAACC"	"RG"
"organoid16.ACACCAAGTTTGGCGC"	"Cycling"
"organoid16.GTAACGTTCCTGTAGA"	"Cycling"
"organoid16.GCATGTATCTATCCCG"	"RG"
"organoid16.TATCTCATCTCGATGA"	"RG"
"organoid16.TGGGAAGAGTACTTGC"	"RG"
"organoid16.TGCGCAGAGATGCCAG"	"Cycling"
"organoid16.TATCAGGAGGGTGTGT"	"RG"
"organoid16.TGTCCCACATCCGGGT"	"RG"
"organoid16.GCATACAAGATGTTAG"	"Cycling"
"organoid16.TGCACCTTCGGATGGA"	"Cycling"
"organoid16.ATCCACCCATACGCTA"	"Cycling"
"organoid16.TCAACGAAGAGTCTGG"	"Cycling"
"organoid16.GCAAACTAGCTGATAA"	"Cycling"
"organoid16.TGTATTCAGTAATCCC"	"Cycling"
"organoid16.CTTTGCGTCAAAGTAG"	"RG"
"organoid16.TAAGCGTTCAACACCA"	"RG"
"organoid16.GGGCATCTCCCTAACC"	"Cycling"
"organoid16.CCTATTACACAACTGT"	"Cycling"
"organoid16.AGCAGCCCACATAACC"	"Cycling"
"organoid16.TGACTTTGTCTAAAGA"	"Cycling"
"organoid16.TTGCCGTAGATATACG"	"RG"
"organoid16.AGATTGCCAATAAGCA"	"Cycling"
"organoid16.CACTCCATCTACCAGA"	"Cycling"
"organoid16.CGAGAAGAGCGGATCA"	"Cycling"
"organoid16.AGGCCACCACAGTCGC"	"RG"
"organoid16.TCAGGATGTCTGATCA"	"Cycling"
"organoid16.GAACGGAGTTCATGGT"	"Cycling"
"organoid16.ACTGTCCCACTTGGAT"	"Cycling"
"organoid16.TAGACCAAGCCAGGAT"	"Cycling"
"organoid16.ATCCGAAAGTGGAGAA"	"Cycling"
"organoid16.CCAATCCGTAATTGGA"	"Cycling"
"organoid16.TGTATTCTCCTAGAAC"	"Cycling"
"organoid16.GCATGATAGAGCCTAG"	"Cycling"
"organoid16.GCGCAGTCACTCTGTC"	"Cycling"
"organoid16.AAGGCAGGTCGGCACT"	"Cycling"
"organoid16.TTCGGTCTCCTAGTGA"	"Cycling"
"organoid16.ATGCGATCAGGATTGG"	"Cycling"
"organoid16.GCTGGGTGTGGTCCGT"	"Cycling"
"organoid16.GGTGTTACAAACCCAT"	"Cycling"
"organoid16.CGATTGATCATGCATG"	"Cycling"
"organoid16.GCGCAGTTCTGATTCT"	"Cycling"
"organoid16.AAAGCAAAGATCGGGT"	"Cycling"
"organoid16.GACTAACTCTTGTCAT"	"Cycling"
"organoid16.TATCAGGGTCCAGTTA"	"RG"
"organoid16.ACATACGTCACGCGGT"	"Cycling"
"organoid16.GAACGGAAGTGACATA"	"Cycling"
"organoid16.ATCATCTGTTACGTCA"	"Cycling"
"organoid16.CTACACCAGCTAGCCC"	"Cycling"
"organoid16.CTGTTTAGTTGCGCAC"	"Cycling"
"organoid16.AAGACCTGTCGTTGTA"	"Cycling"
"organoid16.AGCGTATAGACAAGCC"	"Cycling"
"organoid16.TCAGATGGTGGAAAGA"	"RG"
"organoid16.CAGTAACAGTGAAGTT"	"Cycling"
"organoid16.ATTCTACAGCGATAGC"	"Cycling"
"organoid16.CTAGTGAGTTGCTCCT"	"Cycling"
"organoid16.ATCATCTGTAAATGTG"	"Cycling"
"organoid16.CGATCGGAGTGCTGCC"	"RG"
"organoid16.AACTGGTAGTCACGCC"	"Cycling"
"organoid16.CGTGTAATCAACCATG"	"Cycling"
"organoid16.TCTTCGGAGTCCTCCT"	"Cycling"
"organoid16.GCGCAACTCATGGTCA"	"RG"
"organoid16.TCAACGACACCCTATC"	"RG"
"organoid16.AGGGTGAAGAGAACAG"	"Cycling"
"organoid16.CAAGATCCAGCGTTCG"	"Cycling"
"organoid16.TACGGGCCATCACAAC"	"Cycling"
"organoid16.AGAATAGCAGCCAGAA"	"Cycling"
"organoid16.AACTCAGAGTGGTCCC"	"Cycling"
"organoid16.GTAGGCCTCCGTAGTA"	"Cycling"
"organoid16.GGCAATTGTTCGTTGA"	"RG"
"organoid16.CGTCTACAGAGGTACC"	"Cycling"
"organoid16.ACATCAGGTGCGATAG"	"RG"
"organoid16.CGGCTAGAGCCAACAG"	"Cycling"
"organoid16.TAAACCGTCAGCTCTC"	"Cycling"
"organoid16.ACTGTCCAGCTAGTGG"	"RG"
"organoid16.AGCGTATAGCTCCTCT"	"Cycling"
"organoid16.TACTTGTCATTAGCCA"	"RG"
"organoid16.TTCCCAGGTCCAAGTT"	"RG"
"organoid16.GTCTTCGTCATGTGGT"	"Cycling"
"organoid16.TACCTTAGTGGTCTCG"	"Cycling"
"organoid16.ATCCGAAGTTACGCGC"	"Cycling"
"organoid16.GCGCAACAGACAAGCC"	"RG"
"organoid16.CATCCACAGGAACTGC"	"RG"
"organoid16.AACTTTCGTTGAACTC"	"RG"
"organoid16.CCTTTCTAGTCTCCTC"	"Cycling"
"organoid16.CGACCTTTCGGCATCG"	"Cycling"
"organoid16.AGTTGGTCAGCTCCGA"	"Cycling"
"organoid16.TTAGGCAGTCACTTCC"	"Cycling"
"organoid16.CGTCAGGCACCTCGGA"	"Cycling"
"organoid16.CGCGGTAGTCTTCTCG"	"Cycling"
"organoid16.GTTACAGAGTACGCCC"	"Cycling"
"organoid16.CATATGGTCGCATGGC"	"Cycling"
"organoid16.AGCGTATCAATAAGCA"	"Cycling"
"organoid16.CTTGGCTTCGTTACGA"	"Cycling"
"organoid16.TCTGAGATCACCACCT"	"Cycling"
"organoid16.CAGCGACCAACGCACC"	"Cycling"
"organoid16.CACATTTGTCGCATCG"	"RG"
"organoid16.GGACAGATCTTGTCAT"	"RG"
"organoid16.CCACGGATCCAAACTG"	"Cycling"
"organoid16.TGTATTCCAGACTCGC"	"Cycling"
"organoid16.CCGGGATGTCCCGACA"	"Cycling"
"organoid16.GTCATTTGTCCTCTTG"	"Cycling"
"organoid16.CATGACACAAGCTGAG"	"Cycling"
"organoid16.GGGCATCGTTGCGTTA"	"Cycling"
"organoid16.GTGCTTCTCTCTAAGG"	"Cycling"
"organoid16.ATAACGCGTCTCCACT"	"Cycling"
"organoid16.GAAGCAGGTAGCGCTC"	"RG"
"organoid16.ACGTCAATCTGTCTAT"	"Cycling"
"organoid16.GAACCTAGTTGTCGCG"	"Cycling"
"organoid16.ACCCACTGTTGGACCC"	"Cycling"
"organoid16.GGACGTCAGGTAAACT"	"Cycling"
"organoid16.AGGGAGTCATTTGCCC"	"Cycling"
"organoid16.CAAGAAAAGGAATCGC"	"RG"
"organoid16.GGCTGGTTCATGTAGC"	"Cycling"
"organoid16.AACACGTAGTAGATGT"	"Cycling"
"organoid16.CCTCTGACAAACTGTC"	"Cycling"
"organoid16.TTTCCTCCATTACGAC"	"RG"
"organoid16.GACGGCTGTCACTGGC"	"RG"
"organoid16.TACCTTATCAAGCCTA"	"Cycling"
"organoid16.CGAGCACGTCACACGC"	"Cycling"
"organoid16.CTTTGCGCATCCTTGC"	"RG"
"organoid16.GCGGGTTAGATGGGTC"	"Cycling"
"organoid16.CCTTCCCTCCAAACTG"	"RG"
"organoid16.CAAGGCCCAAACTGTC"	"Cycling"
"organoid16.TGAGGGAAGCGATGAC"	"Cycling"
"organoid16.ACTGATGGTCGGATCC"	"RG"
"organoid16.CTAGAGTCAGCTCGAC"	"Cycling"
"organoid16.TTGTAGGGTCAAAGAT"	"Cycling"
"organoid16.TTCTCCTTCATCTGCC"	"Cycling"
"organoid16.TGTTCCGAGCTGAAAT"	"Cycling"
"organoid16.CTCGTCACACTATCTT"	"Cycling"
"organoid16.CAACCAAGTCTCCACT"	"Cycling"
"organoid16.CAAGATCAGTGGGTTG"	"RG"
"organoid16.TAGACCAAGAGTAAGG"	"RG"
"organoid16.GGTGCGTAGGATGGAA"	"RG"
"organoid16.TTGACTTAGAACAATC"	"Cycling"
"organoid16.AGAGCGAAGTAGCCGA"	"RG"
"organoid16.CGGTTAACAGCTTCGG"	"Cycling"
"organoid16.ACACCGGTCATCTGTT"	"Cycling"
"organoid16.CGTCCATCAGTCAGCC"	"Cycling"
"organoid16.CAGTCCTTCCATGAAC"	"Cycling"
"organoid16.GCACTCTAGCCACGCT"	"Cycling"
"organoid16.TGACTAGCAGGGTTAG"	"Cycling"
"organoid16.TCCACACCATGTAAGA"	"Cycling"
"organoid16.GGATGTTTCCTCAACC"	"Cycling"
"organoid16.CCAATCCAGCACCGTC"	"Cycling"
"organoid16.CACCACTGTGCGATAG"	"Cycling"
"organoid16.CGGACGTTCATCGCTC"	"Cycling"
"organoid16.CGGGTCAAGATCGATA"	"Cycling"
"organoid16.CCTTCCCCAGTTCATG"	"Cycling"
"organoid16.CTGAAGTTCCACGTGG"	"Cycling"
"organoid16.CCACTACGTCCTGCTT"	"RG"
"organoid16.TGCGTGGAGAAGGTGA"	"Cycling"
"organoid16.CAGCGACTCTTGCCGT"	"RG"
"organoid16.ACTGATGGTGCAGGTA"	"Cycling"
"organoid16.CGCTATCGTCAATGTC"	"Cycling"
"organoid16.AAGTCTGGTGCACGAA"	"RG"
"organoid16.TAAGTGCTCTTGTACT"	"Cycling"
"organoid16.GAGTCCGCATTTGCTT"	"Cycling"
"organoid16.GCGAGAAAGGCAGGTT"	"RG"
"organoid16.CATCAAGGTCGCGGTT"	"RG"
"organoid16.GAGTCCGAGTTGAGTA"	"Cycling"
"organoid16.CGACCTTGTGATAAAC"	"Cycling"
"organoid16.ACGCCAGCAACTTGAC"	"Cycling"
"organoid16.ATGAGGGCACGAAACG"	"Cycling"
"organoid16.GATCGTACAGTGGGAT"	"Cycling"
"organoid16.AGAGTGGGTTGTCTTT"	"RG"
"organoid16.TCTCTAAAGCTAGCCC"	"Cycling"
"organoid16.GTGCGGTTCAAGGCTT"	"Cycling"
"organoid16.ACGCCAGCATGCTAGT"	"Cycling"
"organoid16.TGAGCATTCCTCATTA"	"Cycling"
"organoid16.CGACCTTGTAACGACG"	"Cycling"
"organoid16.GGACAGAGTCTTTCAT"	"Cycling"
"organoid16.GGACAAGAGTGGTCCC"	"Cycling"
"organoid16.GCGCGATCAACTGCTA"	"Cycling"
"organoid16.GATCGCGCAGTCAGCC"	"Cycling"
"organoid16.GACGTGCTCCATGAAC"	"Cycling"
"organoid16.CACACCTGTCTCAACA"	"RG"
"organoid16.TTGTAGGGTCAACATC"	"Cycling"
"organoid16.GCGCAACCAACGCACC"	"Cycling"
"organoid16.GGCTGGTCAGGCAGTA"	"Cycling"
"organoid16.ATCATCTGTCACACGC"	"Cycling"
"organoid16.CAGCGACCATTAGGCT"	"RG"
"organoid16.TTAACTCGTAGGGTAC"	"Cycling"
"organoid16.GAGGTGAAGTTCCACA"	"RG"
"organoid16.GAACCTATCTGGGCCA"	"Cycling"
"organoid16.CGACCTTAGATGGGTC"	"Cycling"
"organoid16.AACTTTCCACGGCCAT"	"Cycling"
"organoid16.GATGAGGGTTGAGTTC"	"Cycling"
"organoid16.ACACCGGAGTCCATAC"	"Cycling"
"organoid16.CTACACCTCCGTAGTA"	"Cycling"
"organoid16.ATGAGGGGTCGAATCT"	"RG"
"organoid16.AAAGTAGCACATGTGT"	"Cycling"
"organoid16.GTGCAGCAGACGCTTT"	"Cycling"
"organoid16.GCTGCTTCAATGGTCT"	"Cycling"
"organoid16.GTCTTCGAGGATCGCA"	"Cycling"
"organoid16.ACAGCCGAGATGAGAG"	"RG"
"organoid16.ACGAGCCGTGGTACAG"	"Cycling"
"organoid16.TCAGGTAAGAAACCGC"	"RG"
"organoid16.CCTAGCTAGATGTGTA"	"RG"
"organoid16.GGGACCTTCTGATACG"	"RG"
"organoid16.TTCTTAGGTGGGTATG"	"Cycling"
"organoid16.CTTAACTCAACGATGG"	"Cycling"
"organoid16.GTAACGTCATCCCACT"	"Cycling"
"organoid16.CCCAGTTTCGTGGTCG"	"Cycling"
"organoid16.CATCAGAGTAGCGTGA"	"Cycling"
"organoid16.CTGCTGTAGCACACAG"	"Cycling"
"organoid16.GGGATGAAGACCTAGG"	"Cycling"
"organoid16.GTCATTTGTCCGCTGA"	"Cycling"
"organoid16.CATCCACCATTTGCCC"	"Cycling"
"organoid16.CATGCCTCAAGGCTCC"	"RG"
"organoid16.CTAATGGAGGGATGGG"	"Cycling"
"organoid16.GACACGCCATGAAGTA"	"Cycling"
"organoid16.GAAGCAGCATGGGAAC"	"Cycling"
"organoid16.CATTCGCCATGGTAGG"	"Cycling"
"organoid16.CATGCCTAGAGTCGGT"	"Cycling"
"organoid16.CTTACCGCACAGACTT"	"RG"
"organoid16.AACCATGCAGAGCCAA"	"Cycling"
"organoid16.CTAATGGTCGGATGGA"	"Cycling"
"organoid16.GCGCCAACAAACCTAC"	"Cycling"
"organoid16.TGTATTCAGTGGTAAT"	"Cycling"
"organoid16.GCTCCTAAGCGATGAC"	"Cycling"
"organoid16.ACGATACTCAAACCAC"	"Cycling"
"organoid16.CTTAACTGTCGGCTCA"	"Cycling"
"organoid16.TTGACTTCATCCTAGA"	"Cycling"
"organoid16.GTCTCGTTCACTCTTA"	"RG"
"organoid16.CGGTTAAAGGAGTCTG"	"Cycling"
"organoid16.GATCGTATCTCGGACG"	"Cycling"
"organoid16.AGTGTCACAGATGAGC"	"Cycling"
"organoid16.CCTTACGGTAAACCTC"	"Cycling"
"organoid16.ACTGCTCAGCAGGTCA"	"RG"
"organoid16.CACAGTAAGGTGATTA"	"Cycling"
"organoid16.TTCGGTCCATGTCCTC"	"RG"
"organoid16.TACTTGTCAGCTATTG"	"RG"
"organoid16.GCAGTTAGTGATAAAC"	"RG"
"organoid16.GTGCAGCGTATCACCA"	"RG"
"organoid16.CGAACATTCGCGCCAA"	"RG"
"organoid16.TACTTACCAAGACGTG"	"RG"
"organoid16.CTCGAAACATCGATGT"	"Cycling"
"organoid16.TGGGCGTGTTAGATGA"	"RG"
"organoid16.AGCAGCCGTAAAGTCA"	"Cycling"
"organoid16.GCGACCAGTCCAGTAT"	"Cycling"
"organoid16.CCGGTAGCAACAACCT"	"RG"
"organoid16.GTGCGGTCAAATTGCC"	"RG"
"organoid16.ACTGCTCGTCAAAGCG"	"Cycling"
"organoid16.GTCGGGTAGTTGTCGT"	"Cycling"
"organoid16.CTTGGCTAGGCACATG"	"Cycling"
"organoid16.GTAGTCAGTGATGTGG"	"RG"
"organoid16.TCACAAGTCACCGGGT"	"RG"
"organoid16.AGGGATGTCCTGTACC"	"Cycling"
"organoid16.AGTAGTCGTTGGGACA"	"Cycling"
"organoid16.AGTAGTCTCCTCCTAG"	"Cycling"
"organoid16.AGCAGCCTCATGCTCC"	"RG"
"organoid16.GCGCGATGTTACGACT"	"Cycling"
"organoid16.CAACCTCTCTAAGCCA"	"Cycling"
"organoid16.CGCTGGACAAAGGTGC"	"Cycling"
"organoid16.CACAGGCCACGGTAAG"	"Cycling"
"organoid16.CGTCACTCAGACGCAA"	"RG"
"organoid16.ACGGGCTGTTTGTGTG"	"Cycling"
"organoid16.CAAGAAACATCACGTA"	"Cycling"
"organoid16.GAACGGAGTAAGTGGC"	"RG"
"organoid16.GTACGTAGTTGATTGC"	"Cycling"
"organoid16.GCTGCAGCATGTAAGA"	"Cycling"
"organoid16.TTTGCGCTCCACGTGG"	"Cycling"
"organoid16.GCTGCAGTCTACTTAC"	"Cycling"
"organoid16.GTAGGCCTCATGCATG"	"Cycling"
"organoid16.GCTGGGTGTTCCCTTG"	"Cycling"
"organoid16.CCTCAGTTCCTCGCAT"	"Cycling"
"organoid16.CTCTAATGTATAGGGC"	"Cycling"
"organoid16.ATCTACTAGCGAGAAA"	"Cycling"
"organoid16.AGTAGTCTCAGGCAAG"	"RG"
"organoid16.CTCGGGAGTTCGCTAA"	"Cycling"
"organoid16.TTAACTCAGGGATACC"	"Cycling"
"organoid16.CTGCGGATCCAGTAGT"	"Cycling"
"organoid16.CGGCTAGTCGGGAGTA"	"Cycling"
"organoid16.TACGGATAGTATCGAA"	"Cycling"
"organoid16.CCTCAGTCACACGCTG"	"Cycling"
"organoid16.GCTGCAGAGTGAACAT"	"Cycling"
"organoid16.AGCGGTCTCACCGGGT"	"RG"
"organoid16.GGCGTGTAGGAATGGA"	"Cycling"
"organoid16.GGCGTGTAGTAATCCC"	"Cycling"
"organoid16.GATCGTACATGCAATC"	"Cycling"
"organoid16.CGTAGCGGTCGCCATG"	"Cycling"
"organoid17.CGAATGTAGTTCGATC"	"Cycling"
"organoid17.GGATTACAGATGTAAC"	"Cycling"
"organoid17.TGACTAGGTACCAGTT"	"Cycling"
"organoid17.GATCTAGGTACTCGCG"	"Cycling"
"organoid17.AACACGTTCACGCATA"	"Cycling"
"organoid17.GGTGTTAGTACCGGCT"	"Cycling"
"organoid17.GAGGTGACAGACAAAT"	"Cycling"
"organoid17.TCATTTGCAAAGCAAT"	"Cycling"
"organoid17.CCTTCGAGTCCTCCAT"	"Cycling"
"organoid17.TGCCCTAAGTTTGCGT"	"Cycling"
"organoid17.GCCTCTACAGTTCCCT"	"Cycling"
"organoid17.GTGTTAGTCGTCGTTC"	"Cycling"
"organoid17.AACCATGTCCCTGACT"	"Cycling"
"organoid17.CACCACTAGGTTACCT"	"RG"
"organoid17.GAACCTATCATAGCAC"	"Cycling"
"organoid17.ATCCACCGTCTTCAAG"	"Cycling"
"organoid17.TCTCATATCAGAGGTG"	"Cycling"
"organoid17.TCTCATATCGACAGCC"	"Cycling"
"organoid17.TACAGTGGTCAGAATA"	"Cycling"
"organoid17.ACTTACTAGAATTGTG"	"Cycling"
"organoid17.ATCATGGAGTGTACCT"	"Cycling"
"organoid17.CAAGGCCGTTCATGGT"	"Cycling"
"organoid17.AGGCCGTCATGGTCTA"	"Cycling"
"organoid17.TCGTACCCATCCAACA"	"Cycling"
"organoid17.GTCACAATCCATGAAC"	"Cycling"
"organoid17.CAGATCAGTACATCCA"	"Cycling"
"organoid17.ATCTGCCGTTGGACCC"	"Cycling"
"organoid17.ATCGAGTTCCTGTAGA"	"Cycling"
"organoid17.TGTGTTTAGTTCGCGC"	"Cycling"
"organoid17.GCACATATCTACTCAT"	"Cycling"
"organoid17.TTCCCAGAGCTGCGAA"	"Cycling"
"organoid17.TGAGCATCATCCTAGA"	"Cycling"
"organoid17.AAAGTAGCAAGCTGTT"	"Cycling"
"organoid17.ACTGATGTCCAAATGC"	"Cycling"
"organoid17.ACCGTAATCATGTCTT"	"Cycling"
"organoid17.GTTACAGTCGCACTCT"	"Cycling"
"organoid17.ACCCACTGTACAAGTA"	"Cycling"
"organoid17.TAAGTGCCAATCTACG"	"Cycling"
"organoid17.CCAGCGAGTTGCCTCT"	"Cycling"
"organoid17.TGGCGCATCTCGTATT"	"Cycling"
"organoid17.ATCATGGTCTATCCCG"	"Cycling"
"organoid17.CTCTACGCATGCAATC"	"Cycling"
"organoid17.TGACGGCAGTATTGGA"	"Cycling"
"organoid17.CATATTCGTATAAACG"	"Cycling"
"organoid17.CAGTAACCAAAGGTGC"	"Cycling"
"organoid17.TATTACCAGGAGTACC"	"RG"
"organoid17.ACTGAGTGTAGCAAAT"	"Cycling"
"organoid17.TCAGATGCAAAGGAAG"	"Cycling"
"organoid17.AGAGCTTAGAACTGTA"	"Cycling"
"organoid17.TACACGAAGTGCCAGA"	"Cycling"
"organoid17.CTGTGCTTCCTCATTA"	"RG"
"organoid17.TGACGGCGTTCGTCTC"	"RG"
"organoid17.ACGATGTCAAGTACCT"	"Cycling"
"organoid17.GCGCGATAGCGCCTTG"	"Cycling"
"organoid17.CCTCAGTAGTTGTAGA"	"Cycling"
"organoid17.CCTATTAGTCAAACTC"	"Cycling"
"organoid17.TCGGGACGTTGATTGC"	"Cycling"
"organoid17.GTATCTTGTCCTCTTG"	"Cycling"
"organoid17.GGCAATTGTGAGTGAC"	"Cycling"
"organoid17.ACGGGCTAGCACCGCT"	"Cycling"
"organoid17.TACGGATGTCTCCCTA"	"Cycling"
"organoid17.TACCTATCATATGAGA"	"RG"
"organoid17.CATTATCTCTTGCATT"	"Cycling"
"organoid17.ACACCGGCACGGCGTT"	"RG"
"organoid17.TGAGGGACATCCCACT"	"Cycling"
"organoid17.ATGAGGGCACCGCTAG"	"Cycling"
"organoid17.CTGAAACAGCCACCTG"	"Cycling"
"organoid17.CAGCATATCGCCTGTT"	"RG"
"organoid17.CACCTTGGTGGACGAT"	"RG"
"organoid17.TTTGTCAGTGAGTGAC"	"Cycling"
"organoid17.TGCGTGGAGGCTAGCA"	"Cycling"
"organoid17.AGGGTGACATTGGGCC"	"Cycling"
"organoid17.CTCCTAGCAAGGTGTG"	"RG"
"organoid17.TGACAACTCCAAAGTC"	"RG"
"organoid17.TACACGAGTGGTCTCG"	"Cycling"
"organoid17.AAAGTAGGTGCACTTA"	"Cycling"
"organoid17.TTAGTTCTCGCGTAGC"	"Cycling"
"organoid17.CGTTGGGAGATCCGAG"	"Cycling"
"organoid17.GACTAACTCGGTCTAA"	"Cycling"
"organoid17.CTAAGACGTATTCTCT"	"RG"
"organoid17.CAGAATCTCAAGAAGT"	"Cycling"
"organoid17.GGCGTGTCAGCCAATT"	"Cycling"
"organoid17.GACGCGTAGACGCACA"	"Cycling"
"organoid17.CGTCTACTCCTCGCAT"	"RG"
"organoid17.CATCCACAGCCATCGC"	"Cycling"
"organoid17.GGAAAGCTCGGCTTGG"	"Cycling"
"organoid17.CTGCTGTTCGGAATCT"	"RG"
"organoid17.TTTGTCAGTCCGACGT"	"Cycling"
"organoid17.GGGTCTGAGCACCGCT"	"Cycling"
"organoid17.ACGCAGCAGAGGACGG"	"Cycling"
"organoid17.AGCTTGAAGGCTCAGA"	"Cycling"
"organoid17.TCAGCAAGTCCAAGTT"	"Cycling"
"organoid17.GCATACAGTCTGCCAG"	"Cycling"
"organoid17.TGACAACTCCAGGGCT"	"RG"
"organoid17.TCAGCAACAGTCGATT"	"RG"
"organoid17.AGTGTCACATAAGACA"	"Cycling"
"organoid17.GACGGCTTCCGAACGC"	"Cycling"
"organoid17.TCGCGAGAGCAAATCA"	"Cycling"
"organoid17.AGGGAGTTCCCTGACT"	"RG"
"organoid17.CACATAGGTATTACCG"	"Cycling"
"organoid17.CTTACCGAGCTGGAAC"	"Cycling"
"organoid17.GGAAAGCGTGATAAAC"	"Cycling"
"organoid17.TAGGCATGTAATTGGA"	"RG"
"organoid17.TTCTACACATACTACG"	"RG"
"organoid17.GCTGCAGTCACCTCGT"	"Cycling"
"organoid17.AGCGTATGTAATCACC"	"RG"
"organoid17.ACCCACTAGCCTTGAT"	"Cycling"
"organoid17.GACTACAAGTTCCACA"	"Cycling"
"organoid17.TCGTACCGTGGGTATG"	"Cycling"
"organoid17.AAAGTAGCAAGCGAGT"	"Cycling"
"organoid17.CAAGAAAGTCTCAACA"	"RG"
"organoid17.GATGCTATCCATGAAC"	"RG"
"organoid17.CGACCTTGTCCATGAT"	"RG"
"organoid17.ACTATCTTCGGAATCT"	"Cycling"
"organoid17.CTCGGAGAGCAATATG"	"Cycling"
"organoid17.CAACCTCCACGACGAA"	"Cycling"
"organoid17.GAATAAGTCAGTGTTG"	"Cycling"
"organoid17.ACATGGTAGTGGGTTG"	"RG"
"organoid17.GGCAATTTCCTAGTGA"	"Cycling"
"organoid17.TAGCCGGCATATACCG"	"Cycling"
"organoid17.TGAGAGGAGAGTACAT"	"Cycling"
"organoid17.ACACTGAAGGCGATAC"	"Cycling"
"organoid17.TCACGAATCTCGAGTA"	"RG"
"organoid17.AAGCCGCGTTCCTCCA"	"Cycling"
"organoid17.CTGCTGTCAGTCGTGC"	"Cycling"
"organoid17.AAGTCTGCAAATCCGT"	"Cycling"
"organoid17.GATCGTATCAACACAC"	"Cycling"
"organoid17.AGAATAGCAGTCCTTC"	"Cycling"
"organoid17.TCTGGAAAGAACAACT"	"RG"
"organoid17.TGACTTTAGTAAGTAC"	"RG"
"organoid17.CGTCTACGTTGACGTT"	"Cycling"
"organoid17.GTGTTAGGTTGTACAC"	"Cycling"
"organoid17.CTAGTGAAGGGTGTGT"	"RG"
"organoid17.CCTATTAAGCACGCCT"	"RG"
"organoid17.GCGACCAGTCTGATCA"	"Cycling"
"organoid17.CATCCACCAGGGTATG"	"Cycling"
"organoid17.GCAGCCACAGCTGCTG"	"Cycling"
"organoid17.TAAGAGATCATCGCTC"	"Cycling"
"organoid17.GCTGCAGCAAACTGCT"	"Cycling"
"organoid17.CTTCTCTGTCACCTAA"	"Cycling"
"organoid17.TGAAAGAAGCTGAACG"	"Cycling"
"organoid17.TTCTCAATCTTTCCTC"	"Cycling"
"organoid17.TCCACACGTTGACGTT"	"Cycling"
"organoid17.ATTATCCGTCGTCTTC"	"RG"
"organoid17.AGCAGCCAGAAACCGC"	"Cycling"
"organoid17.GTCACGGTCCTCTAGC"	"RG"
"organoid17.CTAGAGTCAGACGCCT"	"Cycling"
"organoid17.TTCTACAGTGATGCCC"	"Cycling"
"organoid17.CACATAGAGAATGTGT"	"Cycling"
"organoid17.AGTAGTCAGAGGTACC"	"Cycling"
"organoid17.GAGCAGAAGTCTCAAC"	"Cycling"
"organoid17.ACGATACAGATCTGAA"	"Cycling"
"organoid17.CAAGTTGAGATGTTAG"	"RG"
"organoid17.CAAGAAACATCTGGTA"	"Cycling"
"organoid17.TCAGGTATCGAGAACG"	"Cycling"
"organoid17.ATCATCTGTTCACCTC"	"RG"
"organoid17.TTGAACGAGCGCTCCA"	"RG"
"organoid17.GATGAAATCGGCTACG"	"Cycling"
"organoid17.TCAACGAAGAGGTTGC"	"Cycling"
"organoid17.TCCACACGTCCATCCT"	"Cycling"
"organoid17.GACTGCGAGCGTTGCC"	"Cycling"
"organoid17.GGTATTGAGGGAACGG"	"Cycling"
"organoid17.ACTTTCAAGATCCTGT"	"RG"
"organoid17.CGAGCACGTAAACACA"	"Cycling"
"organoid17.AAGGTTCAGTCACGCC"	"Cycling"
"organoid17.TTATGCTCACCTCGTT"	"Cycling"
"organoid17.GGGACCTAGTAGGCCA"	"Cycling"
"organoid17.GCGACCAAGCCGCCTA"	"RG"
"organoid17.ACGGGTCGTTAAGATG"	"RG"
"organoid17.AACTTTCGTCGCGGTT"	"RG"
"organoid17.GACGGCTGTACAGACG"	"Cycling"
"organoid17.TTGCCGTGTCGGCACT"	"Cycling"
"organoid17.GGCCGATTCCGAAGAG"	"RG"
"organoid17.GGATTACCACATGGGA"	"RG"
"organoid17.CCCTCCTAGAACAACT"	"Cycling"
"organoid17.ACATACGAGTCGAGTG"	"Cycling"
"organoid17.CATATTCCAAAGGAAG"	"Cycling"
"organoid17.AAGCCGCAGCTAGTCT"	"RG"
"organoid17.AAGGCAGTCGTAGGTT"	"Cycling"
"organoid17.GATCGTAAGTCAATAG"	"Cycling"
"organoid17.GAGGTGATCCGCGCAA"	"Cycling"
"organoid17.ATCGAGTTCTTGTTTG"	"Cycling"
"organoid17.CATCCACCATTGGTAC"	"Cycling"
"organoid17.AACCATGAGTGGAGAA"	"Cycling"
"organoid17.CGTCTACAGCCCAACC"	"Cycling"
"organoid17.GATGCTAGTCATCCCT"	"RG"
"organoid17.CAAGATCCACCGTTGG"	"Cycling"
"organoid17.CTCGAAATCTACTTAC"	"RG"
"organoid17.GAACATCCATCGGTTA"	"Cycling"
"organoid17.ACCGTAATCCCAACGG"	"RG"
"organoid17.TTTGTCACAGTATCTG"	"Cycling"
"organoid17.GCATACACAGGCAGTA"	"Cycling"
"organoid17.CCAATCCCACGGCTAC"	"Cycling"
"organoid17.GTGCATAAGAAGGTTT"	"Cycling"
"organoid17.GCGCAACCACGTTGGC"	"RG"
"organoid17.CTAAGACCAGGGTTAG"	"Cycling"
"organoid17.AACTCCCTCTCGGACG"	"Cycling"
"organoid17.CGCTATCTCGAGAACG"	"Cycling"
"organoid17.CTAAGACCAGGTCCAC"	"RG"
"organoid17.GGTGTTAGTTGAACTC"	"Cycling"
"organoid17.ACTTACTTCCTAGGGC"	"Cycling"
"organoid17.ACTTGTTGTGACCAAG"	"Cycling"
"organoid17.AAGGTTCTCTAACTGG"	"RG"
"organoid17.GGACAGATCTGCGTAA"	"Cycling"
"organoid17.CACACCTAGTGCCATT"	"Cycling"
"organoid17.CGGACGTAGGGATGGG"	"Cycling"
"organoid17.GATCTAGTCGGTGTCG"	"RG"
"organoid17.TACTCGCAGGCTAGCA"	"RG"
"organoid17.AAACGGGTCTCCAGGG"	"Cycling"
"organoid17.CACAAACCATCCGGGT"	"Cycling"
"organoid17.TAAGTGCGTTAGAACA"	"Cycling"
"organoid17.GCGACCACATCACCCT"	"Cycling"
"organoid17.CCTCAGTTCTGATACG"	"Cycling"
"organoid17.CGAACATAGGTAGCCA"	"Cycling"
"organoid17.GTGCTTCCACTATCTT"	"Cycling"
"organoid17.CTCGTACCAAGCGAGT"	"Cycling"
"organoid17.TGCACCTAGCGATAGC"	"Cycling"
"organoid17.CCGTTCAAGGCTACGA"	"Cycling"
"organoid17.GTCATTTGTCGCGGTT"	"Cycling"
"organoid17.ACATCAGCAACGATCT"	"Cycling"
"organoid17.GCGCGATTCGCTGATA"	"Cycling"
"organoid17.GAACGGATCTGTACGA"	"Cycling"
"organoid17.CCACTACCAGTAGAGC"	"Cycling"
"organoid17.TCAGCTCAGTTGTCGT"	"Cycling"
"organoid17.CTCTGGTAGGACACCA"	"Cycling"
"organoid17.TCGTACCAGTGATCGG"	"Cycling"
"organoid17.GGAATAACACGCATCG"	"Cycling"
"organoid17.CCTTTCTGTTGTGGAG"	"Cycling"
"organoid17.CTCTAATAGAAGGTTT"	"Cycling"
"organoid17.GAGCAGACAACGCACC"	"Cycling"
"organoid17.CTGTTTAGTCGCGGTT"	"Cycling"
"organoid17.ATAGACCTCTGTACGA"	"Cycling"
"organoid17.ACATGGTCATCGACGC"	"Cycling"
"organoid17.CCTCTGAAGGATGTAT"	"RG"
"organoid17.CATATTCGTTCAGGCC"	"Cycling"
"organoid17.AGCTCCTAGGCCATAG"	"Cycling"
"organoid17.GAACCTACAGTATAAG"	"Cycling"
"organoid17.TGGACGCCAGGTCCAC"	"Cycling"
"organoid17.AGGGAGTCAAGTCTAC"	"Cycling"
"organoid17.AAACCTGAGACAGAGA"	"RG"
"organoid17.ATAGACCTCGGCGGTT"	"Cycling"
"organoid17.CCGTTCACAGCCTTGG"	"Cycling"
"organoid17.AAACCTGTCTAGAGTC"	"Cycling"
"organoid17.CGAGCCATCAATCACG"	"Cycling"
"organoid17.GATGAGGCATTACGAC"	"Cycling"
"organoid17.CTTAGGAAGCGGCTTC"	"Cycling"
"organoid17.CCCATACTCGCGGATC"	"Cycling"
"organoid17.ACCTTTACAGATCTGT"	"Cycling"
"organoid17.TCGCGAGGTAAGGGCT"	"Cycling"
"organoid17.TCGTACCCAATACGCT"	"Cycling"
"organoid17.GATTCAGAGCGTTCCG"	"Cycling"
"organoid17.TGTGGTATCAACCAAC"	"Cycling"
"organoid17.CAGCTAATCCAAACAC"	"Cycling"
"organoid17.GTAACTGGTATGAAAC"	"Cycling"
"organoid17.CCGGGATTCCAAAGTC"	"RG"
"organoid17.AGATTGCTCCTATGTT"	"Cycling"
"organoid17.CGTTAGAGTGGCTCCA"	"RG"
"organoid17.GTATTCTCATATGAGA"	"Cycling"
"organoid17.GCGCAGTTCGTGGGAA"	"Cycling"
"organoid17.TTAGGCATCCAACCAA"	"Cycling"
"organoid17.TTAACTCCAGCGATCC"	"Cycling"
"organoid17.CAGAATCTCAGAGGTG"	"Cycling"
"organoid17.CGCTATCGTAGATTAG"	"Cycling"
"organoid17.TGACTAGAGCTCCTTC"	"Cycling"
"organoid17.CTGGTCTAGAACAATC"	"Cycling"
"organoid17.ACCCACTTCGTTTATC"	"Cycling"
"organoid17.AGCCTAAAGTCACGCC"	"Cycling"
"organoid17.ACATGGTTCGAATGGG"	"Cycling"
"organoid17.ACGAGCCAGGTGCACA"	"Cycling"
"organoid17.GTCGTAAAGACCACGA"	"Cycling"
"organoid17.CATGACACATGGAATA"	"Cycling"
"organoid17.CCTACACAGCACACAG"	"Cycling"
"organoid17.TCAACGACACATCCAA"	"Cycling"
"organoid17.GGGTTGCTCGCCATAA"	"Cycling"
"organoid17.CTACACCAGGGTATCG"	"Cycling"
"organoid17.ACTATCTGTGGACGAT"	"RG"
"organoid17.GATGAGGCAGAGCCAA"	"Cycling"
"organoid17.GGGAGATCAATAGCGG"	"Cycling"
"organoid17.TGCCCTAAGATCCGAG"	"Cycling"
"organoid17.CTCGTCACAAAGGTGC"	"Cycling"
"organoid17.TACGGATCATATACCG"	"Cycling"
"organoid17.CTGATAGAGTAGGTGC"	"RG"
"organoid17.GTTCATTCAGGCTCAC"	"RG"
"organoid17.AACTCTTAGGCCCGTT"	"Cycling"
"organoid17.CGTTAGACACTTCTGC"	"Cycling"
"organoid17.ACAGCCGGTAGCTTGT"	"Cycling"
"organoid17.AGATTGCGTCTTCGTC"	"Cycling"
"organoid17.TTTGGTTCACGGTGTC"	"Cycling"
"organoid17.ACGATACGTGCAGGTA"	"Cycling"
"organoid17.ATCACGACATTTCAGG"	"Cycling"
"organoid17.GCTTCCAAGGGCTCTC"	"Cycling"
"organoid17.CATCAGAAGTAGATGT"	"Cycling"
"organoid17.GACTAACAGAGGTTAT"	"Cycling"
"organoid17.GATCGATTCGAGAACG"	"Cycling"
"organoid17.ATTCTACAGACTACAA"	"Cycling"
"organoid17.TTCTCCTAGCTAGGCA"	"Cycling"
"organoid17.GATCGTACACTGCCAG"	"Cycling"
"organoid17.CGGACTGTCAAAGACA"	"Cycling"
"organoid17.GTTTCTATCTAAGCCA"	"Cycling"
"organoid17.GCTGCTTTCAGCGACC"	"Cycling"
"organoid17.AAAGATGGTGCAACGA"	"Cycling"
"organoid17.CTAAGACTCTTGGGTA"	"Cycling"
"organoid17.ACTGCTCTCGTTGACA"	"Cycling"
"organoid17.CTACATTCAGCTGTGC"	"Cycling"
"organoid17.ACGAGCCAGAGTTGGC"	"Cycling"
"organoid17.GTGCTTCTCATCACCC"	"Cycling"
"organoid17.CGGAGTCAGCTAAACA"	"Cycling"
"organoid17.GGGACCTGTGGCTCCA"	"Cycling"
"organoid17.CAGCAGCCAAGTAGTA"	"Cycling"
"organoid17.ACGTCAAGTATTACCG"	"RG"
"organoid17.GAGCAGATCACCAGGC"	"RG"
"organoid17.CTACACCGTCGCGGTT"	"Cycling"
"organoid17.GACCTGGCACCTTGTC"	"RG"
"organoid17.CATCCACCATACGCCG"	"Cycling"
"organoid17.CTCGAGGTCGCTGATA"	"RG"
"organoid17.CACACTCCAAGCGAGT"	"Cycling"
"organoid17.GCCAAATCATGCTGGC"	"Cycling"
"organoid17.CATTATCGTCCGCTGA"	"RG"
"organoid17.TTGAACGAGCTAGGCA"	"Cycling"
"organoid17.CTCCTAGTCCTGTAGA"	"RG"
"organoid17.ACGTCAACATTCACTT"	"Cycling"
"organoid17.CATATTCGTCTAAAGA"	"Cycling"
"organoid17.CGAGAAGAGCCAACAG"	"Cycling"
"organoid17.CACACCTCATTAACCG"	"Cycling"
"organoid17.CTGATAGTCCACGCAG"	"Cycling"
"organoid17.TAAGAGAAGCTGTTCA"	"Cycling"
"organoid17.GAGGTGAAGGCGATAC"	"Cycling"
"organoid17.ACGCCGAAGGCCCTCA"	"Cycling"
"organoid17.ACATCAGAGGATATAC"	"Cycling"
"organoid17.CAGTAACGTGTTGGGA"	"Cycling"
"organoid17.GTACTTTGTGTGGCTC"	"Cycling"
"organoid17.GTATCTTCACCATGTA"	"Cycling"
"organoid17.TTTACTGCATCGGGTC"	"Cycling"
"organoid17.CAGAATCCAAACAACA"	"Cycling"
"organoid17.TTAGTTCGTCACAAGG"	"Cycling"
"organoid17.CGACTTCGTAGTACCT"	"Cycling"
"organoid17.CACCAGGTCCAAAGTC"	"RG"
"organoid17.CTTGGCTAGGTCGGAT"	"Cycling"
"organoid17.CTTAGGAAGTCACGCC"	"Cycling"
"organoid17.TACTTGTTCTTCGAGA"	"Cycling"
"organoid17.GACAGAGCATACAGCT"	"Cycling"
"organoid17.ACGGGCTTCGCAAGCC"	"Cycling"
"organoid17.CCCAATCTCCTCAATT"	"Cycling"
"organoid17.CATCAGAAGAGAACAG"	"Cycling"
"organoid17.GTTTCTACAATAGCAA"	"RG"
"organoid17.CAGCATATCCCTAATT"	"Cycling"
"organoid17.CGGGTCACATACCATG"	"Cycling"
"organoid17.ACATCAGTCAGTTAGC"	"Cycling"
"organoid17.GATCAGTCAAGGTTTC"	"Cycling"
"organoid17.TGCGGGTCATATGGTC"	"Cycling"
"organoid17.GGATGTTTCAACACGT"	"RG"
"organoid17.CTCTGGTCAACGATCT"	"Cycling"
"organoid17.GCAGTTAGTCCGAACC"	"Cycling"
"organoid17.CAGCTAACATCATCCC"	"Cycling"
"organoid17.GCTGCTTCATTGGGCC"	"Cycling"
"organoid17.CTCGTCAGTGTGAAAT"	"Cycling"
"organoid17.TACGGTACAGCTCGCA"	"Cycling"
"organoid17.AGCTCTCAGTGAACGC"	"Cycling"
"organoid17.GATGCTAAGAGGTACC"	"RG"
"organoid17.CACACAATCTTAACCT"	"Cycling"
"organoid17.TCATTTGCAAGCTGGA"	"Cycling"
"organoid17.CATCAAGAGGACGAAA"	"Cycling"
"organoid17.TGAGCATCACGGCCAT"	"Cycling"
"organoid17.TCTCTAATCTCCAGGG"	"Cycling"
"organoid17.TGACGGCGTAAACACA"	"Cycling"
"organoid17.TGACAACAGCACCGTC"	"Cycling"
"organoid17.CTGTGCTAGGCGACAT"	"Cycling"
"organoid17.AACACGTCACGGTGTC"	"Cycling"
"organoid17.GTGTTAGTCAACACGT"	"Cycling"
"organoid17.GAATAAGGTCAGAATA"	"Cycling"
"organoid17.CTGTGCTAGCTAGTCT"	"Cycling"
"organoid17.CCTACACAGGCTCTTA"	"Cycling"
"organoid17.CGCCAAGAGTTGCAGG"	"Cycling"
"organoid17.GCAGCCAAGCTGTCTA"	"Cycling"
"organoid17.AGTAGTCGTGGTGTAG"	"Cycling"
"organoid17.AGGGAGTGTTTCGCTC"	"RG"
"organoid17.AGTGTCACATCCAACA"	"Cycling"
"organoid17.TCCCGATAGTCGCCGT"	"Cycling"
"organoid17.GGTGTTATCAACGAAA"	"Cycling"
"organoid17.CCGTTCAGTCCGTGAC"	"Cycling"
"organoid17.AAGGTTCGTAAGCACG"	"Cycling"
"organoid17.CGACCTTGTCAAAGCG"	"Cycling"
"organoid17.CTTTGCGAGTGGTCCC"	"RG"
"organoid17.CTCGTACCATTTGCTT"	"Cycling"
"organoid17.CACACTCGTGCAGGTA"	"Cycling"
"organoid17.CATTATCCAAAGGTGC"	"Cycling"
"organoid17.TTGAACGTCGGACAAG"	"Cycling"
"organoid17.AGACGTTAGGCGACAT"	"Cycling"
"organoid17.AGTCTTTGTCCGAGTC"	"Cycling"
"organoid17.CCTTCGACAGGATTGG"	"Cycling"
"organoid17.GCAATCATCAAGATCC"	"Cycling"
"organoid17.TTAGGACCAATCAGAA"	"RG"
"organoid17.GAATAAGTCATGCTCC"	"RG"
"organoid17.AGCAGCCTCCAGGGCT"	"Cycling"
"organoid17.GCACATACAATCTACG"	"Cycling"
"organoid17.CGATCGGGTTCCCTTG"	"Cycling"
"organoid17.GCGGGTTCAGGAATCG"	"Cycling"
"organoid17.CTCACACCAGGATCGA"	"Cycling"
"organoid17.GACGGCTTCCATGAGT"	"Cycling"
"organoid17.CTGCCTACAAGCGTAG"	"Cycling"
"organoid17.GTCTCGTAGCTCCTTC"	"RG"
"organoid17.ACTGCTCAGTCCATAC"	"Cycling"
"organoid17.AGCTTGATCCGCGCAA"	"Cycling"
"organoid17.AACTCTTGTCAATGTC"	"Cycling"
"organoid17.AACCGCGCAGTAACGG"	"RG"
"organoid17.ATGTGTGCATTAACCG"	"Cycling"
"organoid17.GCACTCTAGTTAACGA"	"Cycling"
"organoid17.TTGCGTCTCACTTCAT"	"Cycling"
"organoid17.AGTGAGGTCGCAGGCT"	"Cycling"
"organoid17.CTTACCGTCACCAGGC"	"RG"
"organoid17.CATTCGCAGGGAGTAA"	"Cycling"
"organoid17.GGCGTGTTCCGTAGTA"	"Cycling"
"organoid17.ATCTACTCAGGCGATA"	"Cycling"
"organoid17.ATTGGTGCATCAGTCA"	"Cycling"
"organoid17.CAGCCGATCTTCATGT"	"Cycling"
"organoid17.CAGATCATCCGTAGGC"	"Cycling"
"organoid17.ATAACGCTCAGGTTCA"	"RG"
"organoid17.GGCTCGATCCACTGGG"	"Cycling"
"organoid17.AACTCAGCAGACAGGT"	"Cycling"
"organoid17.ATCTACTAGAAGATTC"	"Cycling"
"organoid17.TGACGGCCACTGAAGG"	"Cycling"
"organoid17.GTCACGGTCAGCGATT"	"Cycling"
"organoid17.CCTATTACATGACATC"	"Cycling"
"organoid17.ATAGACCGTCTCACCT"	"Cycling"
"organoid17.CGGACGTTCTTTACAC"	"Cycling"
"organoid17.CCGGGATTCCGAGCCA"	"Cycling"
"organoid17.GTGTGCGTCATCGCTC"	"RG"
"organoid17.TGCCAAAAGCTGCAAG"	"Cycling"
"organoid17.CTTCTCTCAATGGACG"	"Cycling"
"organoid17.GGCGTGTTCCCTAATT"	"Cycling"
"organoid17.GGACGTCCATCCGTGG"	"Cycling"
"organoid17.GCTCCTAAGCTATGCT"	"Cycling"
"organoid17.AGGTCCGAGGGTTCCC"	"Cycling"
"organoid17.TGCGTGGTCACCTTAT"	"Cycling"
"organoid17.TCTGAGACATGGATGG"	"Cycling"
"organoid17.CGCGTTTAGGCTCAGA"	"RG"
"organoid17.GATCGCGCAGCTGCAC"	"Cycling"
"organoid17.TACAGTGCAAGGCTCC"	"Cycling"
"organoid17.TTTGTCACATCGACGC"	"Cycling"
"organoid17.CATATGGCAAAGAATC"	"Cycling"
"organoid17.ACCAGTATCTCTTGAT"	"Cycling"
"organoid17.TGCTACCCACAGGTTT"	"Cycling"
"organoid17.CCTAAAGGTACCGTTA"	"Cycling"
"organoid17.ATAACGCGTTATCGGT"	"Cycling"
"organoid17.AGCTTGATCCTAGTGA"	"RG"
"organoid17.GGAATAACATGCCACG"	"Cycling"
"organoid17.AGAGCTTAGCACAGGT"	"Cycling"
"organoid17.ACACTGACACGGTAGA"	"RG"
"organoid17.CAGAGAGAGACGCACA"	"Cycling"
"organoid17.GGACAGAGTAGCGATG"	"Cycling"
"organoid17.CTCGAGGCATCCGTGG"	"Cycling"
"organoid17.TAAACCGAGCGTAATA"	"RG"
"organoid17.TGAGCCGTCTACGAGT"	"Cycling"
"organoid17.CACAGGCAGCTGTTCA"	"Cycling"
"organoid17.CGGACACCAATCTACG"	"Cycling"
"organoid17.AGAATAGGTCCAGTTA"	"Cycling"
"organoid17.AACCGCGTCTTGCAAG"	"RG"
"organoid17.TCAGGTACAGGTGCCT"	"Cycling"
"organoid17.GGAGCAAAGTCCGGTC"	"Cycling"
"organoid17.ATCCGAATCGGTCCGA"	"Cycling"
"organoid17.CAGAGAGGTCTCTTAT"	"Cycling"
"organoid17.GATCGATCACATTAGC"	"Cycling"
"organoid17.CTCGAGGAGACGCACA"	"Cycling"
"organoid17.GTATTCTGTCCGAATT"	"Cycling"
"organoid17.AGACGTTCAAGTCATC"	"Cycling"
"organoid17.CTACACCCATATGAGA"	"Cycling"
"organoid17.CCGGGATCAAACTGTC"	"Cycling"
"organoid17.TGACGGCGTAATCGTC"	"Cycling"
"organoid17.GGATGTTTCGTAGGTT"	"Cycling"
"organoid17.CTGTGCTCACGCTTTC"	"RG"
"organoid17.ATTCTACCACGAAAGC"	"Cycling"
"organoid17.CTGATAGCATACTACG"	"Cycling"
"organoid17.CCACTACAGGGTTCCC"	"RG"
"organoid17.TTGCGTCTCACTGGGC"	"Cycling"
"organoid17.TAGAGCTCACCTGGTG"	"Cycling"
"organoid17.AAAGCAATCAACGGCC"	"Cycling"
"organoid17.GCTGCGACAATAACGA"	"Cycling"
"organoid17.TATGCCCGTGTAAGTA"	"Cycling"
"organoid17.ATCACGAAGTTAACGA"	"RG"
"organoid17.CGAACATTCGTTACGA"	"Cycling"
"organoid17.CCTTACGCACGACGAA"	"Cycling"
"organoid17.GGCTGGTCATCAGTAC"	"Cycling"
"organoid17.TTCGGTCGTTCAGTAC"	"Cycling"
"organoid17.GTCTCGTGTTTGCATG"	"Cycling"
"organoid17.AGACGTTAGTGACATA"	"Cycling"
"organoid17.GGATGTTAGGACGAAA"	"Cycling"
"organoid17.GATGCTATCTGTCAAG"	"Cycling"
"organoid17.TTGAACGCAGTATCTG"	"Cycling"
"organoid17.TTGAACGGTGTGAAAT"	"RG"
"organoid17.TTCCCAGCATCCGCGA"	"Cycling"
"organoid17.TGGCGCACACTGCCAG"	"Cycling"
"organoid17.TCCACACTCATCACCC"	"Cycling"
"organoid17.GCTCTGTGTGGTCCGT"	"Cycling"
"organoid17.AAATGCCTCTTAGCCC"	"RG"
"organoid17.GGAACTTTCTCAACTT"	"Cycling"
"organoid17.GACGCGTGTCGTGGCT"	"Cycling"
"organoid17.GTCACAAGTTACAGAA"	"Cycling"
"organoid17.TCAACGACAATGACCT"	"Cycling"
"organoid17.GCAGCCAAGAAGAAGC"	"Cycling"
"organoid17.AGATTGCCACAGGCCT"	"Cycling"
"organoid17.TACAGTGTCGGAGCAA"	"Cycling"
"organoid17.CCCAGTTTCGCACTCT"	"Cycling"
"organoid17.CCCATACCACAACGTT"	"Cycling"
"organoid17.CACACCTTCCATTCTA"	"Cycling"
"organoid17.TGACGGCAGACAGAGA"	"RG"
"organoid17.CCTAAAGAGCCTCGTG"	"RG"
"organoid17.CAACCTCTCCTATTCA"	"Cycling"
"organoid17.ACACTGACAGCTGGCT"	"Cycling"
"organoid17.CATCGGGTCTAGCACA"	"Cycling"
"organoid17.GCCAAATAGGGATCTG"	"RG"
"organoid17.TCACAAGTCAAGAAGT"	"Cycling"
"organoid17.TGGTTCCTCAGCTCTC"	"Cycling"
"organoid17.CAGGTGCGTAGTACCT"	"Cycling"
"organoid17.CCGTACTCATCCAACA"	"Cycling"
"organoid17.CCGTTCATCATTTGGG"	"Cycling"
"organoid17.CACCACTGTTCAGACT"	"Cycling"
"organoid17.AACCGCGTCAGCGATT"	"Cycling"
"organoid17.GGACAAGAGCGAAGGG"	"Cycling"
"organoid17.TGAGCCGTCAGGCAAG"	"RG"
"organoid17.CAAGAAAGTACATGTC"	"Cycling"
"organoid17.CACATTTCATGGTCTA"	"Cycling"
"organoid17.CGGCTAGTCGCCATAA"	"RG"
"organoid17.TGGCTGGAGGTTCCTA"	"Cycling"
"organoid17.CATGACAAGCGATATA"	"Cycling"
"organoid17.ACTGATGGTCATACTG"	"Cycling"
"organoid17.TCTCTAATCAGTTGAC"	"RG"
"organoid17.CGCTGGAGTCAGCTAT"	"Cycling"
"organoid17.CCTACACGTACTTAGC"	"Cycling"
"organoid17.GGGACCTGTGCAGGTA"	"RG"
"organoid17.CTCGTCAGTTCCTCCA"	"Cycling"
"organoid17.CTAGCCTTCTATCGCC"	"Cycling"
"organoid17.CTAGCCTTCTCCAGGG"	"Cycling"
"organoid17.CTTGGCTTCATAACCG"	"Cycling"
"organoid17.GTAGTCATCGTTGCCT"	"Cycling"
"organoid17.GACTGCGTCCGGCACA"	"Cycling"
"organoid17.TGGCCAGTCACATACG"	"Cycling"
"organoid17.CTACACCGTACCGCTG"	"Cycling"
"organoid17.AGCGTCGCAGAAGCAC"	"Cycling"
"organoid17.CACCTTGGTAGATTAG"	"Cycling"
"organoid17.GCAGTTAGTCATCCCT"	"Cycling"
"organoid17.TGGACGCCAAACAACA"	"RG"
"organoid17.CCCTCCTAGTGGCACA"	"Cycling"
"organoid17.GGATGTTCAGCTGGCT"	"Cycling"
"organoid17.ACACCAACAATGGAGC"	"RG"
"organoid17.AGGGATGGTCTCAACA"	"Cycling"
"organoid17.ACTGTCCTCAACGCTA"	"Cycling"
"organoid17.CTGTGCTAGGCTACGA"	"Cycling"
"organoid17.CTGCTGTCATATACCG"	"RG"
"organoid17.CAAGAAAAGTGCCATT"	"Cycling"
"organoid17.TTAACTCTCCACGACG"	"Cycling"
"organoid17.TGGGAAGTCTGGTTCC"	"Cycling"
"organoid17.TATGCCCAGACCCACC"	"Cycling"
"organoid17.ACTTTCATCAAGATCC"	"Cycling"
"organoid17.TGCACCTAGTCGCCGT"	"Cycling"
"organoid17.CCTTACGGTAATCGTC"	"RG"
"organoid17.TGTTCCGGTAGATTAG"	"Cycling"
"organoid17.TCGCGAGTCTGCTGTC"	"Cycling"
"organoid17.ATAACGCAGGGCTTGA"	"Cycling"
"organoid17.CGCGGTATCTTTCCTC"	"Cycling"
"organoid17.AAAGCAAGTTGTACAC"	"Cycling"
"organoid17.GCGCAGTCACGTGAGA"	"Cycling"
"organoid17.CTGGTCTGTTACGACT"	"Cycling"
"organoid17.TGAGAGGAGCGGCTTC"	"Cycling"
"organoid17.GTACGTATCGCTTGTC"	"RG"
"organoid17.CTCTAATTCAATACCG"	"Cycling"
"organoid17.GAAACTCTCCTGCCAT"	"Cycling"
"organoid17.CTCGGGAGTGCCTGGT"	"Cycling"
"organoid17.TCACAAGAGTGTCCCG"	"RG"
"organoid17.GCGGGTTGTAAGCACG"	"Cycling"
"organoid17.GGGACCTAGTGCCATT"	"RG"
"organoid17.AACTCCCGTGATGTGG"	"RG"
"organoid17.CGCTGGAAGATGGGTC"	"Cycling"
"organoid17.TTAGGCAAGGCACATG"	"RG"
"organoid17.GGGCACTGTAAGTGGC"	"RG"
"organoid17.TCAGCTCCAGATCTGT"	"Cycling"
"organoid17.ACGATGTGTACGACCC"	"Cycling"
"organoid17.GCGCGATAGTAGCGGT"	"Cycling"
"organoid17.CATGGCGCAACTGCTA"	"Cycling"
"organoid17.GTCTTCGGTCTGGAGA"	"RG"
"organoid17.TGACGGCCAGTCCTTC"	"Cycling"
"organoid17.TTGCGTCCAGATCCAT"	"Cycling"
"organoid17.AGTGGGATCACCATAG"	"Cycling"
"organoid17.CGCTATCGTGCCTGGT"	"Cycling"
"organoid17.TCGAGGCAGTCACGCC"	"Cycling"
"organoid17.CCTTTCTGTTACGCGC"	"Cycling"
"organoid17.TAAGCGTCATGCAATC"	"Cycling"
"organoid17.TTATGCTAGACACGAC"	"Cycling"
"organoid17.CTTAACTAGGACCACA"	"Cycling"
"organoid17.CGCTATCCAATCGAAA"	"Cycling"
"organoid17.GGTGAAGCACGACGAA"	"RG"
"organoid17.CACATTTTCACTCTTA"	"RG"
"organoid17.TGAGCCGCATCACGAT"	"Cycling"
"organoid17.TTAGGCACACCACGTG"	"Cycling"
"organoid17.TGAGCATCACTGAAGG"	"Cycling"
"organoid17.CGACCTTCAATGGACG"	"RG"
"organoid17.TTAGTTCAGCGATGAC"	"RG"
"organoid17.ACAGCTATCGTCTGCT"	"RG"
"organoid17.CAAGAAAAGGCGCTCT"	"RG"
"organoid17.GGCTCGAGTCCAGTGC"	"Cycling"
"organoid17.CATCCACTCTAACTTC"	"Cycling"
"organoid17.TACTCGCCACCGTTGG"	"Cycling"
"organoid17.CGGACTGTCAAGAAGT"	"RG"
"organoid17.CGGCTAGAGTGTCTCA"	"Cycling"
"organoid17.CGGACACGTGAAGGCT"	"RG"
"organoid17.GTCCTCAGTCCGAAGA"	"Cycling"
"organoid17.GTGTTAGTCTGATTCT"	"Cycling"
"organoid17.CTCACACTCGCAAGCC"	"Cycling"
"organoid17.AGGGAGTCAATGACCT"	"Cycling"
"organoid17.ACCCACTCAGCTGTTA"	"Cycling"
"organoid17.GGGTTGCGTGGTAACG"	"Cycling"
"organoid17.AGCGTCGAGATGGGTC"	"Cycling"
"organoid17.CTCTGGTGTGTGAAAT"	"Cycling"
"organoid17.CGGACTGCAATCGAAA"	"Cycling"
"organoid17.GCTTGAATCGGCGCAT"	"RG"
"organoid17.TGGCCAGAGTGGTAGC"	"RG"
"organoid17.GGCGTGTAGTGGCACA"	"Cycling"
"organoid18.AGAGCTTAGCACCGTC"	"Cycling"
"organoid18.CAGAGAGCAATGTTGC"	"Cycling"
"organoid18.CATGACATCGGCTTGG"	"Cycling"
"organoid18.CAACCTCTCCTCAATT"	"Cycling"
"organoid18.ACATGGTAGTGATCGG"	"Cycling"
"organoid18.GCGCAACGTTATTCTC"	"Cycling"
"organoid18.TGCCCATCAGCGTCCA"	"Cycling"
"organoid18.CTTTGCGCATGAAGTA"	"Cycling"
"organoid18.GGGTTGCGTACATGTC"	"Cycling"
"organoid18.TAGCCGGCACATGGGA"	"Cycling"
"organoid18.GAGTCCGCAATACGCT"	"Cycling"
"organoid18.TGGTTCCTCTCGTTTA"	"Cycling"
"organoid18.CCTCTGAAGGGTTTCT"	"RG"
"organoid18.AACACGTTCGGCCGAT"	"Cycling"
"organoid18.CCTCTGAAGATATGCA"	"Cycling"
"organoid18.TGGCGCAGTTTGGCGC"	"Cycling"
"organoid18.TTTACTGAGTGTACCT"	"Cycling"
"organoid18.GGCAATTCATTGGCGC"	"Cycling"
"organoid18.GACCAATAGATATGGT"	"Cycling"
"organoid18.GACCAATAGCAGATCG"	"Cycling"
"organoid18.CCTACACTCGGCCGAT"	"Cycling"
"organoid18.GGGCATCCACCGGAAA"	"Cycling"
"organoid18.GCGCGATCACACTGCG"	"Cycling"
"organoid18.TTGGCAATCATGTAGC"	"Cycling"
"organoid18.CAAGTTGGTAATCACC"	"Cycling"
"organoid18.TTCTTAGCAATGGTCT"	"Cycling"
"organoid18.TATCAGGCACATGTGT"	"Cycling"
"organoid18.TGCGCAGGTCTCCACT"	"Cycling"
"organoid18.CGATGGCCATTCTTAC"	"Cycling"
"organoid18.GTCCTCAAGCGGATCA"	"Cycling"
"organoid18.CGTCAGGGTTGGTAAA"	"Cycling"
"organoid18.GTTACAGAGGCCCGTT"	"Cycling"
"organoid18.GTCCTCACAATGGATA"	"Cycling"
"organoid18.TACTTACTCGCTTAGA"	"Cycling"
"organoid18.CAGCATAGTGCAGTAG"	"Cycling"
"organoid18.GGTGTTATCTAAGCCA"	"Cycling"
"organoid18.AGAGCTTGTGCCTTGG"	"Cycling"
"organoid18.ATGTGTGCATGTAGTC"	"Cycling"
"organoid18.TTTATGCCATCTGGTA"	"Cycling"
"organoid18.TTCTTAGCAGACGCTC"	"Cycling"
"organoid18.CGCCAAGTCCCGACTT"	"RG"
"organoid18.TCTCTAACATTTCAGG"	"Cycling"
"organoid18.TCGTACCAGACTTGAA"	"Cycling"
"organoid18.CACATAGGTACTCGCG"	"Cycling"
"organoid18.AACTCTTAGCAAATCA"	"Cycling"
"organoid18.ATCTACTAGCGATAGC"	"Cycling"
"organoid18.CATGACAGTACATGTC"	"Cycling"
"organoid18.ATTCTACGTTACGACT"	"Cycling"
"organoid18.CTACGTCAGCTAGTTC"	"Cycling"
"organoid18.CATCGGGAGTTGTAGA"	"Cycling"
"organoid18.GATGAGGAGAGTCGGT"	"Cycling"
"organoid18.TTTACTGGTAAGTGGC"	"Cycling"
"organoid18.ACGGCCATCGGAATCT"	"Cycling"
"organoid18.CGTCACTAGCCAGGAT"	"RG"
"organoid18.CATCAGACAGTGACAG"	"Cycling"
"organoid18.TCAACGAGTGAACCTT"	"Cycling"
"organoid18.CAGAGAGGTCGAATCT"	"Cycling"
"organoid18.CATATGGCACCCTATC"	"Cycling"
"organoid18.CCTTACGCAAACAACA"	"RG"
"organoid18.CTGCTGTGTACATGTC"	"Cycling"
"organoid18.AGGCCGTAGTGCCAGA"	"RG"
"organoid18.GTGCGGTGTTACGCGC"	"Cycling"
"organoid18.ATCACGATCGCATGGC"	"Cycling"
"organoid18.CTTACCGAGACCGGAT"	"Cycling"
"organoid18.ACGTCAAGTCAAAGCG"	"Cycling"
"organoid18.ACGCCGATCATAAAGG"	"RG"
"organoid18.CGAGAAGGTATCGCAT"	"Cycling"
"organoid18.CGAGCCATCAAAGACA"	"Cycling"
"organoid18.TCAGCAACATCGGGTC"	"Cycling"
"organoid18.AAACGGGTCAGCTTAG"	"Cycling"
"organoid18.GGTGCGTGTTCGCTAA"	"RG"
"organoid18.CATGGCGTCTTCAACT"	"Cycling"
"organoid18.TGAAAGACAATGTAAG"	"Cycling"
"organoid18.CCTACCAGTTCGTGAT"	"Cycling"
"organoid18.TGATTTCAGCTTATCG"	"Cycling"
"organoid18.GGACAGAGTGTCTGAT"	"Cycling"
"organoid18.AGGTCCGCAGACTCGC"	"Cycling"
"organoid18.GAAACTCGTAGCGATG"	"Cycling"
"organoid18.TTGGAACAGTATCGAA"	"Cycling"
"organoid18.CCTTCGATCGTCCGTT"	"Cycling"
"organoid18.TTCGGTCCACCTATCC"	"Cycling"
"organoid18.TACAGTGAGTGGTCCC"	"Cycling"
"organoid18.CTAGTGATCCGCGCAA"	"Cycling"
"organoid18.CCGTGGAAGTGTCTCA"	"Cycling"
"organoid18.AGCTTGACAATCACAC"	"Cycling"
"organoid18.GATCGCGAGACTTTCG"	"RG"
"organoid18.TAGTTGGAGTACTTGC"	"Cycling"
"organoid18.GAACATCAGCGTCTAT"	"Cycling"
"organoid18.CCGGTAGTCCAAACAC"	"Cycling"
"organoid18.TTATGCTTCTCGCTTG"	"RG"
"organoid18.GACTACATCAACACGT"	"Cycling"
"organoid18.CTGAAACAGAAGATTC"	"Cycling"
"organoid18.GCGCGATGTAGGGACT"	"Cycling"
"organoid18.AGAATAGTCTGCTGTC"	"RG"
"organoid18.GCGCCAAAGCCTTGAT"	"RG"
"organoid18.TGGCCAGGTATATGGA"	"Cycling"
"organoid18.ATGCGATAGTAGCCGA"	"Cycling"
"organoid18.GGAACTTGTACTTGAC"	"Cycling"
"organoid18.GCTGCTTAGATTACCC"	"Cycling"
"organoid18.CTCGTCAGTTCGGGCT"	"Cycling"
"organoid18.GGGCATCTCAACACCA"	"RG"
"organoid18.GGTGTTACAACTGCGC"	"Cycling"
"organoid18.CTCGAGGTCTTCCTTC"	"RG"
"organoid18.GGGAATGCAATGAAAC"	"Cycling"
"organoid18.TTCTACACAGTTAACC"	"RG"
"organoid18.TCATTACAGTAGCGGT"	"Cycling"
"organoid18.ACGAGCCGTAAACCTC"	"RG"
"organoid18.CGAGCACAGGGATACC"	"Cycling"
"organoid18.GGATGTTGTCTACCTC"	"Cycling"
"organoid18.TAAGCGTAGCTCAACT"	"Cycling"
"organoid18.TTCGAAGAGAGAGCTC"	"Cycling"
"organoid18.TATCTCAGTTCTGTTT"	"Cycling"
"organoid18.TCATTTGTCCTAAGTG"	"RG"
"organoid18.ATGAGGGAGCTAGCCC"	"Cycling"
"organoid18.ACGCAGCAGATATGCA"	"RG"
"organoid18.ACAGCCGCACATTCGA"	"Cycling"
"organoid18.CTGGTCTAGAGCTGGT"	"Cycling"
"organoid18.GGGCACTTCACATAGC"	"RG"
"organoid18.TCAGATGAGAAGATTC"	"Cycling"
"organoid18.CTTGGCTTCATGTCCC"	"Cycling"
"organoid18.TTCTACAGTAGCGCTC"	"Cycling"
"organoid18.AGAGCTTCAGTATGCT"	"Cycling"
"organoid18.GGTGAAGGTTGCCTCT"	"Cycling"
"organoid18.TTTCCTCAGAAGAAGC"	"RG"
"organoid18.CTTAACTTCTACCAGA"	"RG"
"organoid18.GTTCATTCAAGTTCTG"	"Cycling"
"organoid18.AGACGTTCACCAGCAC"	"Cycling"
"organoid18.GACTAACTCTCAAACG"	"Cycling"
"organoid18.TTTATGCTCGTGGACC"	"Cycling"
"organoid18.TCTTCGGAGGTGCAAC"	"Cycling"
"organoid18.CTGTGCTCAACACCTA"	"Cycling"
"organoid18.CGGAGCTGTACTTAGC"	"RG"
"organoid18.CGTTCTGAGATGTCGG"	"Cycling"
"organoid18.GCAGTTACACATTTCT"	"Cycling"
"organoid18.GGGCACTGTAAACACA"	"Cycling"
"organoid18.CTGCTGTAGTCACGCC"	"Cycling"
"organoid18.CCGGTAGGTTAGAACA"	"Cycling"
"organoid18.TCAGCTCAGCCGTCGT"	"Cycling"
"organoid18.ACAGCCGAGCAATATG"	"Cycling"
"organoid18.CCACTACTCAGCATGT"	"Cycling"
"organoid18.TTAGGACAGGCGCTCT"	"Cycling"
"organoid18.GCATGTAAGTACGCCC"	"RG"
"organoid18.CTTCTCTCAACGCACC"	"Cycling"
"organoid18.TCTATTGTCCTTAATC"	"Cycling"
"organoid18.GATGAGGGTCCAAGTT"	"Cycling"
"organoid18.GAAGCAGAGTTAACGA"	"Cycling"
"organoid18.GCTGCAGCATCGGAAG"	"Cycling"
"organoid18.ACGTCAATCGTTACGA"	"Cycling"
"organoid18.GAGTCCGTCACGACTA"	"RG"
"organoid18.TGATTTCGTCTCTTTA"	"Cycling"
"organoid18.CTTTGCGCATGGATGG"	"RG"
"organoid18.GGGAATGCACTCTGTC"	"Cycling"
"organoid18.TTAGTTCCAATACGCT"	"Cycling"
"organoid18.GGAATAAGTGCCTGCA"	"RG"
"organoid18.CGGTTAACATTCTCAT"	"RG"
"organoid18.GTGTGCGTCCAAGTAC"	"Cycling"
"organoid18.ACTGAGTCAGCGAACA"	"Cycling"
"organoid18.ACGAGCCCACATGGGA"	"Cycling"
"organoid18.TGGCGCAGTCCAGTTA"	"Cycling"
"organoid18.TACCTTATCACGAAGG"	"Cycling"
"organoid18.CTACATTCAGTCACTA"	"Cycling"
"organoid18.TAGAGCTTCAGCCTAA"	"RG"
"organoid18.ACCCACTGTGTGAAAT"	"RG"
"organoid18.CTCACACAGCCTCGTG"	"Cycling"
"organoid18.ATGCGATTCAGAAATG"	"Cycling"
"organoid18.CGTCTACGTTGTACAC"	"Cycling"
"organoid18.GGGTTGCCATTAACCG"	"Cycling"
"organoid18.ACAGCTAAGAGTCTGG"	"Cycling"
"organoid18.GCATGTATCTGATACG"	"Cycling"
"organoid18.ATGAGGGCATATGGTC"	"Cycling"
"organoid18.GCATGATAGTAGGTGC"	"Cycling"
"organoid18.AAGTCTGCAAGTACCT"	"Cycling"
"organoid18.TGCGTGGAGCGCTCCA"	"Cycling"
"organoid18.ACTTACTTCACCTTAT"	"RG"
"organoid18.AACCATGAGACAATAC"	"RG"
"organoid18.GGAAAGCAGGGAGTAA"	"Cycling"
"organoid18.GACGTTAGTGCTTCTC"	"Cycling"
"organoid18.AGAATAGAGTGGACGT"	"Cycling"
"organoid18.CAGCAGCCACGGTAGA"	"Cycling"
"organoid18.CGACCTTCAGCTCGAC"	"Cycling"
"organoid18.ATCCACCGTCAGTGGA"	"Cycling"
"organoid18.GACGGCTCAGTCAGAG"	"Cycling"
"organoid18.CTGATCCAGTCGATAA"	"Cycling"
"organoid18.GGACGTCGTCCGAAGA"	"RG"
"organoid18.TCTGAGAAGCAAATCA"	"RG"
"organoid18.GGCGACTCAACCGCCA"	"Cycling"
"organoid18.CCGTTCACATCTACGA"	"Cycling"
"organoid18.CAGCCGAAGTACGTTC"	"RG"
"organoid18.CAAGATCAGCGTAGTG"	"Cycling"
"organoid18.TCACAAGCACATCCGG"	"RG"
"organoid18.GATGAAAGTTTAGCTG"	"RG"
"organoid18.AACTCAGAGCTGTTCA"	"Cycling"
"organoid18.ACTGCTCCACCACCAG"	"RG"
"organoid18.CTGAAGTAGGAGTTTA"	"Cycling"
"organoid18.CAGTAACAGGAGTAGA"	"Cycling"
"organoid18.GCGCAACGTTCCAACA"	"Cycling"
"organoid18.GCCTCTATCTATCGCC"	"RG"
"organoid18.GCCTCTACACCAGATT"	"Cycling"
"organoid18.AGTGTCACACTGTTAG"	"Cycling"
"organoid18.TGGTTAGTCGGTCTAA"	"Cycling"
"organoid18.ATGTGTGTCTTGCAAG"	"Cycling"
"organoid18.CGGAGCTCAGTCCTTC"	"Cycling"
"organoid18.CTACACCAGGGAAACA"	"Cycling"
"organoid18.AAAGTAGGTATTACCG"	"Cycling"
"organoid18.AGCATACAGCTCAACT"	"Cycling"
"organoid18.TCTTCGGCATGGTCAT"	"Cycling"
"organoid18.CATCGAAGTCTCTTAT"	"Cycling"
"organoid18.GAGTCCGGTCGCCATG"	"RG"
"organoid18.CCATGTCTCTGAAAGA"	"Cycling"
"organoid18.TGCCCTATCCTAGAAC"	"Cycling"
"organoid18.CCGGGATAGGTCGGAT"	"Cycling"
"organoid18.CCTAAAGGTGTGCGTC"	"Cycling"
"organoid18.CATATGGAGCTTATCG"	"Cycling"
"organoid18.CCTCTGATCCTCATTA"	"Cycling"
"organoid18.TGCGCAGTCCTTTACA"	"Cycling"
"organoid18.TCACGAACAGCATACT"	"Cycling"
"organoid18.CGGACACCAAACCTAC"	"Cycling"
"organoid18.AAGTCTGCATGGGAAC"	"Cycling"
"organoid18.ACCCACTCATCGGTTA"	"Cycling"
"organoid18.TCGGTAAAGGCAATTA"	"Cycling"
"organoid18.CCGTTCAGTTACCAGT"	"Cycling"
"organoid18.CCGGTAGCATTTCAGG"	"RG"
"organoid18.ACACCAAAGTGGAGAA"	"RG"
"organoid18.ACTGAACAGGCTATCT"	"Cycling"
"organoid18.TGAGCCGGTTTGGGCC"	"Cycling"
"organoid18.GGGAATGGTCGAATCT"	"Cycling"
"organoid18.CACCTTGAGATGTCGG"	"RG"
"organoid18.AGCTCCTGTCACACGC"	"RG"
"organoid18.TTTGGTTGTTATCGGT"	"Cycling"
"organoid18.CAGCAGCGTGTGCGTC"	"Cycling"
"organoid18.ACGAGCCGTGTCGCTG"	"Cycling"
"organoid18.CAGCTAATCTAGCACA"	"Cycling"
"organoid18.GATCAGTCAGGATCGA"	"Cycling"
"organoid18.GTCTTCGAGAATGTTG"	"Cycling"
"organoid18.CGATGTACAGGTCCAC"	"Cycling"
"organoid18.GATGCTAAGGAATGGA"	"Cycling"
"organoid18.GGGATGAAGTGATCGG"	"Cycling"
"organoid18.GCGCCAATCTGATACG"	"Cycling"
"organoid18.TTGCGTCAGCTGAACG"	"RG"
"organoid18.TGACGGCGTAGCCTAT"	"RG"
"organoid18.TTAACTCTCACCCTCA"	"Cycling"
"organoid18.TTTACTGTCTACCTGC"	"Cycling"
"organoid18.CAAGGCCCACTTGGAT"	"Cycling"
"organoid18.GAAACTCTCAGGATCT"	"Cycling"
"organoid18.TTTGCGCTCTATGTGG"	"Cycling"
"organoid18.CTTGGCTCAAAGGTGC"	"Cycling"
"organoid18.TTAACTCAGAGCCCAA"	"Cycling"
"organoid18.TACGGGCGTCAACATC"	"Cycling"
"organoid18.TTATGCTCATCGTCGG"	"RG"
"organoid18.CGGGTCAAGGAATCGC"	"Cycling"
"organoid18.TGCGTGGCAAGCCGCT"	"Cycling"
"organoid18.ACACCAAAGAGTAAGG"	"Cycling"
"organoid18.ATCATGGTCAACTCTT"	"Cycling"
"organoid18.CCATTCGCACTATCTT"	"Cycling"
"organoid18.ACGGGTCGTAAGTGGC"	"Cycling"
"organoid18.CAGTCCTGTAAACGCG"	"Cycling"
"organoid18.ACGTCAAGTAAGTGTA"	"Cycling"
"organoid18.AGCGTCGCAGCTATTG"	"Cycling"
"organoid18.ATTATCCGTTTCGCTC"	"Cycling"
"organoid18.AGAGCGAAGGGTGTGT"	"Cycling"
"organoid18.GTGCGGTTCCTCAACC"	"Cycling"
"organoid18.CTGTGCTAGAGACTAT"	"Cycling"
"organoid18.TCACAAGGTGAGCGAT"	"Cycling"
"organoid18.GTTAAGCGTATTAGCC"	"RG"
"organoid18.TACTCATCAATGGTCT"	"Cycling"
"organoid18.TGAGGGATCACCATAG"	"Cycling"
"organoid18.TGACAACTCGTGGTCG"	"Cycling"
"organoid18.CATCAGATCAGTCCCT"	"Cycling"
"organoid18.GATGAGGGTACGAAAT"	"Cycling"
"organoid18.CCTACACTCTCAAGTG"	"Cycling"
"organoid18.TAAGAGAGTCGGCATC"	"Cycling"
"organoid18.GCTTGAAAGCGAGAAA"	"Cycling"
"organoid18.AAAGTAGCAGGTCTCG"	"Cycling"
"organoid18.GGAAAGCTCTTGAGAC"	"Cycling"
"organoid18.TACTTACAGGATGTAT"	"Cycling"
"organoid18.GCGCGATAGACGCAAC"	"Cycling"
"organoid18.GTATTCTAGAGCTGGT"	"Cycling"
"organoid18.CGTCTACCACATGGGA"	"Cycling"
"organoid18.GCAGTTAAGTGTCTCA"	"Cycling"
"organoid18.GTGTTAGTCTGTCTCG"	"Cycling"
"organoid18.TTCTACAGTTCCACGG"	"Cycling"
"organoid18.TCAGCAAAGGGTGTTG"	"Cycling"
"organoid18.TGAGGGATCCACTGGG"	"Cycling"
"organoid18.CAAGGCCCACGCCAGT"	"Cycling"
"organoid18.CCGTACTCAGGATCGA"	"Cycling"
"organoid18.GCATACACACACCGCA"	"Cycling"
"organoid18.TACGGATAGAATTCCC"	"Cycling"
"organoid18.GCTGCGATCATGGTCA"	"Cycling"
"organoid18.GCATGATGTAGCGTAG"	"Cycling"
"organoid18.TCGTACCGTCCGAAGA"	"Cycling"
"organoid18.GATTCAGTCGATGAGG"	"Cycling"
"organoid18.TGAGCATTCAACCAAC"	"RG"
"organoid18.CAGAGAGTCCACGACG"	"Cycling"
"organoid18.AGCAGCCGTTCCATGA"	"Cycling"
"organoid18.ATTATCCGTCACACGC"	"Cycling"
"organoid18.ATCTGCCTCTATCGCC"	"Cycling"
"organoid18.TGAGCCGCAGTCGATT"	"Cycling"
"organoid18.CCTTTCTAGAGGTACC"	"Cycling"
"organoid18.CGGACACAGAAGAAGC"	"Cycling"
"organoid18.TTTACTGAGCCAGAAC"	"Cycling"
"organoid18.CCACGGAGTAAGTGGC"	"Cycling"
"organoid18.AGTGGGACAGATGAGC"	"Cycling"
"organoid18.CAAGGCCGTCGGGTCT"	"RG"
"organoid18.ACGGAGAGTCTGGAGA"	"Cycling"
"organoid18.CGGACGTTCGTGACAT"	"Cycling"
"organoid18.CATTCGCTCTCTAAGG"	"Cycling"
"organoid18.AGCGGTCTCATGGTCA"	"Cycling"
"organoid18.TCAGCAATCTTGAGGT"	"Cycling"
"organoid18.TTGCGTCGTCCGTTAA"	"Cycling"
"organoid18.GTCACGGAGAGTACAT"	"RG"
"organoid18.TGGTTCCCAAGCCTAT"	"Cycling"
"organoid18.TCACGAAAGATAGTCA"	"Cycling"
"organoid18.CCGTGGACACGTTGGC"	"Cycling"
"organoid18.AAAGATGCATCTCCCA"	"Cycling"
"organoid18.AAAGTAGAGTACCGGA"	"RG"
"organoid18.ACTGAACGTGAGTATA"	"Cycling"
"organoid18.ATCCACCGTTCACCTC"	"Cycling"
"organoid18.CCCAATCGTTATGCGT"	"Cycling"
"organoid18.CTCTACGGTAGCTTGT"	"Cycling"
"organoid18.CGAGCCACAATGAATG"	"Cycling"
"organoid18.CATGCCTTCGCGTTTC"	"Cycling"
"organoid18.TTGTAGGAGTGCCAGA"	"Cycling"
"organoid18.CCTAAAGCATACCATG"	"Cycling"
"organoid18.AGCGTCGGTTTCGCTC"	"Cycling"
"organoid18.AGTGGGACAAGTCTGT"	"Cycling"
"organoid18.TTTGTCACACAGGAGT"	"RG"
"organoid18.CACCTTGAGTGACATA"	"RG"
"organoid18.AGAGCTTGTTCGCGAC"	"Cycling"
"organoid18.GGAAAGCAGTCCTCCT"	"Cycling"
"organoid18.CTACACCCATTTCACT"	"Cycling"
"organoid18.TACACGAGTGACGGTA"	"Cycling"
"organoid18.AACTTTCAGTAGGCCA"	"Cycling"
"organoid18.AAGGCAGCAGGTGCCT"	"Cycling"
"organoid18.GATTCAGGTTGAGTTC"	"Cycling"
"organoid18.GGGCATCGTGCTCTTC"	"Cycling"
"organoid18.TGGGAAGCACGTTGGC"	"Cycling"
"organoid18.CTAGCCTAGGTCATCT"	"Cycling"
"organoid18.CGCGGTATCTACCTGC"	"RG"
"organoid18.TGAGAGGCACTGCCAG"	"Cycling"
"organoid18.TTATGCTCAATGGATA"	"Cycling"
"organoid18.TCAGCAAGTTGGTAAA"	"Cycling"
"organoid18.CGGTTAAAGGGCTCTC"	"RG"
"organoid18.GTTACAGTCTTCGGTC"	"Cycling"
"organoid18.CGTGTCTCAAGTCTGT"	"RG"
"organoid18.CTGCCTATCAGGTTCA"	"Cycling"
"organoid18.TCGAGGCTCGAATGGG"	"RG"
"organoid18.GCCAAATCAGGCTGAA"	"Cycling"
"organoid18.TTTGGTTCACCAGTTA"	"Cycling"
"organoid18.AGCGTATGTAGGCTGA"	"RG"
"organoid18.TATGCCCTCGAATGGG"	"RG"
"organoid18.AAGGCAGGTCTAGGTT"	"RG"
"organoid18.ACAGCTACATCTCGCT"	"Cycling"
"organoid18.ATCCGAACACTTCGAA"	"Cycling"
"organoid18.GACGGCTGTTGATTCG"	"Cycling"
"organoid18.CTGAAGTCACAACGTT"	"Cycling"
"organoid18.GAACCTAGTATAGGTA"	"Cycling"
"organoid18.AGCTTGATCGTCCGTT"	"Cycling"
"organoid18.TATCTCACACTATCTT"	"RG"
"organoid18.CTGATCCCACAGGTTT"	"Cycling"
"organoid18.TAGCCGGAGTTTCCTT"	"Cycling"
"organoid18.AGGGAGTGTCTACCTC"	"Cycling"
"organoid18.ACATGGTTCTAAGCCA"	"RG"
"organoid18.GGCGACTGTTGGTGGA"	"Cycling"
"organoid18.AGATCTGGTCTGATTG"	"Cycling"
"organoid18.TACCTTAGTCTAGCGC"	"Cycling"
"organoid18.AATCCAGTCGTATCAG"	"Cycling"
"organoid18.CTAACTTTCGCTTAGA"	"Cycling"
"organoid18.CGACCTTGTCCGACGT"	"Cycling"
"organoid18.AGCGGTCTCAGAGCTT"	"Cycling"
"organoid18.TAGCCGGGTACCTACA"	"Cycling"
"organoid18.GCACATAAGCGTTGCC"	"Cycling"
"organoid18.GGTGAAGTCCACTCCA"	"Cycling"
"organoid18.AAGGAGCTCGCTTGTC"	"Cycling"
"organoid18.TTGCCGTGTCCCTACT"	"Cycling"
"organoid18.GTGCATACATAAGACA"	"Cycling"
"organoid18.GCTCCTAAGGTGATAT"	"Cycling"
"organoid18.GCGGGTTCAGGACGTA"	"Cycling"
"organoid18.GTCTTCGTCTGCGACG"	"Cycling"
"organoid18.GTGTTAGAGCATCATC"	"Cycling"
"organoid18.GTGCATATCATGCATG"	"Cycling"
"organoid18.GTATTCTGTATGGTTC"	"Cycling"
"organoid18.TGTCCCACACCTGGTG"	"Cycling"
"organoid18.CATATTCTCAGTCAGT"	"Cycling"
"organoid18.GCCTCTAAGATATGGT"	"Cycling"
"organoid18.GGGACCTAGAAGAAGC"	"Cycling"
"organoid18.TGACGGCTCCGTAGTA"	"Cycling"
"organoid18.CTCGAAACAAACCCAT"	"Cycling"
"organoid18.GCATGCGGTCTAGTCA"	"Cycling"
"organoid18.TCGCGTTGTAAGTGGC"	"RG"
"organoid18.ACCTTTAAGATGTGTA"	"Cycling"
"organoid18.CATGCCTTCTGCAGTA"	"RG"
"organoid18.ACATACGTCGAGAACG"	"Cycling"
"organoid18.AACGTTGTCTCGAGTA"	"Cycling"
"organoid18.TCGGGACTCAGCGACC"	"Cycling"
"organoid18.CAAGAAAAGAGTACAT"	"Cycling"
"organoid18.ATTATCCTCGTAGGAG"	"Cycling"
"organoid18.TCCCGATAGAATAGGG"	"Cycling"
"organoid18.TACTCATAGGAGTTTA"	"Cycling"
"organoid18.GGTGCGTCAAAGGCGT"	"Cycling"
"organoid18.CCGGTAGTCACTGGGC"	"Cycling"
"organoid18.CTACGTCAGACGCTTT"	"Cycling"
"organoid18.TCATTACGTGCCTTGG"	"RG"
"organoid18.AGTGTCACAAGCCATT"	"RG"
"organoid18.TTGGAACGTCGGGTCT"	"Cycling"
"organoid18.CCCTCCTTCTTCTGGC"	"Cycling"
"organoid18.CACATTTCACTTACGA"	"Cycling"
"organoid18.GGAACTTTCGGCCGAT"	"RG"
"organoid18.CGCGGTACAGCATACT"	"Cycling"
"organoid18.CTTAGGAGTCGCGAAA"	"Cycling"
"organoid18.GTCACGGAGTGCGTGA"	"Cycling"
"organoid18.CCCAATCGTGCACCAC"	"RG"
"organoid18.TAGTTGGTCAGCTTAG"	"Cycling"
"organoid18.CGTGTCTTCACCCTCA"	"Cycling"
"organoid18.ACACCCTGTAGCGATG"	"Cycling"
"organoid18.AAGCCGCGTCCATCCT"	"Cycling"
"organoid18.ACAGCTACACCACGTG"	"Cycling"
"organoid18.CTAGTGAAGAAGCCCA"	"Cycling"
"organoid18.CTGCCTAAGGACTGGT"	"Cycling"
"organoid18.CCGGGATTCGTGACAT"	"Cycling"
"organoid18.CTGTGCTCACCGTTGG"	"RG"
"organoid18.TCTATTGCATCCGCGA"	"Cycling"
"organoid18.TTCTCAACATTCCTGC"	"Cycling"
"organoid18.ATAGACCGTAGCGTGA"	"RG"
"organoid18.GCGAGAATCCTTTACA"	"Cycling"
"organoid18.CTGCGGACACCAGCAC"	"RG"
"organoid18.CTTTGCGGTGAAGGCT"	"Cycling"
"organoid18.GCGCAACGTATATCCG"	"Cycling"
"organoid18.CATTCGCCAATAGAGT"	"Cycling"
"organoid18.TTTATGCTCTTGTTTG"	"Cycling"
"organoid18.ACTGAACTCATGCAAC"	"Cycling"
"organoid18.TTCGAAGTCTGGTGTA"	"Cycling"
"organoid18.ACGGCCAAGACAGGCT"	"RG"
"organoid18.AAGGTTCTCCAGTAGT"	"RG"
"organoid18.TCGAGGCGTGTTTGTG"	"Cycling"
"organoid18.TGAGAGGTCCCGGATG"	"Cycling"
"organoid18.GGACGTCAGAAGGTTT"	"RG"
"organoid18.TGAAAGAAGAGGACGG"	"Cycling"
"organoid18.AGCATACCACCGAAAG"	"Cycling"
"organoid18.GTCACGGAGATACACA"	"Cycling"
"organoid18.AGGGATGGTAAGTGGC"	"RG"
"organoid18.CGAGCACGTCGCGGTT"	"Cycling"
"organoid18.GTAACGTAGTTATCGC"	"RG"
"organoid18.ACGGCCACATGCAACT"	"Cycling"
"organoid18.ACCAGTACAACAACCT"	"RG"
"organoid18.GGGACCTCACCAGATT"	"Cycling"
"organoid18.TTGACTTAGATGTAAC"	"Cycling"
"organoid18.GCTCCTAGTGTATGGG"	"Cycling"
"organoid18.GGGATGAGTCGAGTTT"	"Cycling"
"organoid18.CCCAGTTGTGTGAAAT"	"RG"
"organoid18.TAGAGCTTCCTCTAGC"	"Cycling"
"organoid18.CAAGAAATCTGACCTC"	"RG"
"organoid18.ACGCCAGCATCGGACC"	"Cycling"
"organoid18.GTATCTTAGCTCCCAG"	"Cycling"
"organoid18.GTGTTAGCAGGAATGC"	"Cycling"
"organoid18.AACCATGCAAGACGTG"	"Cycling"
"organoid18.CTACATTTCTGAGGGA"	"Cycling"
"organoid18.CTAGAGTAGAACAATC"	"RG"
"organoid18.TCGCGTTGTCTAGTGT"	"Cycling"
"organoid18.GCAGCCAAGATACACA"	"Cycling"
"organoid18.CAGTCCTGTCTTCTCG"	"Cycling"
"organoid18.CTAAGACCATACTCTT"	"Cycling"
"organoid18.AACTCAGCACCGAATT"	"Cycling"
"organoid18.CTGATAGAGAGCTATA"	"Cycling"
"organoid18.CTCAGAAAGGCTCAGA"	"Cycling"
"organoid18.ATCCACCAGAGTGAGA"	"Cycling"
"organoid18.ATTACTCCACCGCTAG"	"RG"
"organoid18.CTAATGGGTGCCTTGG"	"Cycling"
"organoid18.GGACAGATCTTATCTG"	"RG"
"organoid18.CAGCTGGCACGGATAG"	"RG"
"organoid18.CGACCTTGTCTAAAGA"	"RG"
"organoid18.TTGCCGTCAGGGTATG"	"Cycling"
"organoid18.TACCTTACACGCATCG"	"Cycling"
"organoid18.TGTTCCGCAGGACCCT"	"Cycling"
"organoid18.GCAGCCAGTCTAGGTT"	"Cycling"
"organoid18.ATGTGTGGTCCAACTA"	"Cycling"
"organoid18.GATTCAGAGACTACAA"	"Cycling"
"organoid18.ACGAGGAGTATAGGGC"	"RG"
"organoid18.TTTACTGCAGATCCAT"	"Cycling"
"organoid18.CCTACACCACCGAATT"	"Cycling"
"organoid18.CCGTTCACATGGTCTA"	"Cycling"
"organoid18.CTACATTAGGCTCATT"	"RG"
"organoid18.ACTATCTCACGCGAAA"	"RG"
"organoid18.CTCGTCAGTTTCCACC"	"RG"
"organoid18.CAGTAACAGAATGTGT"	"RG"
"organoid18.CCTAGCTTCACTTATC"	"Cycling"
"organoid18.GTTAAGCTCGGATGGA"	"RG"
"organoid18.ATCGAGTGTAGCGATG"	"RG"
"organoid18.ACGGCCACATTACGAC"	"Cycling"
"organoid18.GACGCGTCACCTGGTG"	"Cycling"
"organoid18.TAAGTGCTCGAATCCA"	"Cycling"
"organoid18.CGGGTCATCCCAAGTA"	"Cycling"
"organoid18.TCCACACTCGCCAAAT"	"Cycling"
"organoid18.ATCGAGTAGTAGCGGT"	"Cycling"
"organoid18.GAATGAAAGTCTCCTC"	"Cycling"
"organoid18.CCCTCCTAGTGACATA"	"Cycling"
"organoid18.GACTACAGTCCGAATT"	"Cycling"
"organoid18.CTGATAGAGAGGTACC"	"RG"
"organoid18.CGCTGGAGTCATGCAT"	"Cycling"
"organoid18.GTAACGTCACATAACC"	"Cycling"
"organoid18.TTGGAACGTGTAATGA"	"RG"
"organoid18.CATCAAGGTTATGTGC"	"Cycling"
"organoid18.AACTTTCTCGGCGCTA"	"Cycling"
"organoid18.TCAGGATAGCGGCTTC"	"Cycling"
"organoid18.AGATTGCGTGGTTTCA"	"RG"
"organoid18.GACCTGGGTAGCGCAA"	"Cycling"
"organoid18.ACACCAACATCGATGT"	"Cycling"
"organoid18.GTTCTCGCACTGTTAG"	"Cycling"
"organoid18.CAGAATCCAGGACGTA"	"RG"
"organoid18.TGGACGCTCCTAAGTG"	"Cycling"
"organoid18.TAAGAGAGTTCCCGAG"	"Cycling"
"organoid18.GCTTGAAAGGTGGGTT"	"Cycling"
"organoid18.GATGAAAGTTGTGGCC"	"RG"
"organoid18.CGATTGACACATGGGA"	"RG"
"organoid18.AGCTCTCCACTGTCGG"	"RG"
"organoid18.CGATTGAGTCAATACC"	"RG"
"organoid18.ACGGGTCGTAGCGTAG"	"Cycling"
"organoid18.CGGAGTCCACCCAGTG"	"Cycling"
"organoid18.AGAGCGATCTGAAAGA"	"Cycling"
"organoid18.AAGGAGCCATGATCCA"	"Cycling"
"organoid18.CATCGAAAGACGCTTT"	"RG"
"organoid18.GAAATGAAGAGGTTAT"	"RG"
"organoid18.GTTCATTAGACACGAC"	"Cycling"
"organoid18.TACCTATTCTTCATGT"	"Cycling"
"organoid18.AGATCTGAGAACTGTA"	"Cycling"
"organoid18.ACCTTTACAGCTCCGA"	"Cycling"
"organoid18.GGGCACTCACGAGAGT"	"RG"
"organoid18.ACATCAGTCCTGCCAT"	"Cycling"
"organoid18.CCTTACGGTGTATGGG"	"Cycling"
"organoid18.GCTCCTACACTAAGTC"	"Cycling"
"organoid18.TGCCCATGTATTCTCT"	"Cycling"
"organoid18.GTTCATTTCTCTGAGA"	"RG"
"organoid18.TTCTTAGGTTAGAACA"	"Cycling"
"organoid18.GGAAAGCTCCTACAGA"	"RG"
"organoid18.GTCACGGGTCGCATCG"	"Cycling"
"organoid18.CATCAAGAGGGTGTGT"	"Cycling"
"organoid18.CAGCCGATCGGAGCAA"	"Cycling"
"organoid18.TAGCCGGCAGTGGAGT"	"Cycling"
"organoid18.ACCAGTACAGCCTATA"	"Cycling"
"organoid18.CAGCTGGCATGAAGTA"	"Cycling"
"organoid18.AACTGGTCACGTCTCT"	"Cycling"
"organoid18.AAACGGGTCAATAAGG"	"Cycling"
"organoid18.CACAGGCAGGCTACGA"	"Cycling"
"organoid18.GAACCTACAACGATCT"	"Cycling"
"organoid18.GCACTCTGTAAGTGGC"	"Cycling"
"organoid18.CAGGTGCGTATAGGGC"	"RG"
"organoid18.ACTGAACGTTCCTCCA"	"Cycling"
"organoid18.TTCTCAAAGCGTTGCC"	"Cycling"
"organoid18.TGGCTGGTCTGTCAAG"	"Cycling"
"organoid18.CGGAGTCTCAGCTTAG"	"RG"
"organoid18.GTCTTCGGTGTTCGAT"	"Cycling"
"organoid18.GACGGCTTCCAGAGGA"	"Cycling"
"organoid18.TTCTTAGAGTTGTAGA"	"Cycling"
"organoid18.TCTTTCCGTAGCGCTC"	"Cycling"
"organoid18.GTGTTAGAGCAGCGTA"	"Cycling"
"organoid18.CTACCCAGTCGCGGTT"	"Cycling"
"organoid18.TCGGGACTCGCCTGAG"	"Cycling"
"organoid18.CTCGAGGTCACATAGC"	"Cycling"
"organoid18.ATAAGAGGTTACGACT"	"Cycling"
"organoid18.TGCTGCTCAATGGTCT"	"Cycling"
"organoid18.CGAGCACGTCTTTCAT"	"Cycling"
"organoid18.CGCTGGAGTTCCCGAG"	"Cycling"
"organoid18.CGTGAGCCAGGTCGTC"	"RG"
"organoid18.AGCGTCGAGCGCCTCA"	"Cycling"
"organoid18.GATCGCGTCGTTACGA"	"Cycling"
